ang	Chinese
auyong	Chinese
bai	Chinese
ban	Chinese
bao	Chinese
bei	Chinese
bian	Chinese
bui	Chinese
cai	Chinese
cao	Chinese
cen	Chinese
chai	Chinese
chaim	Chinese
chan	Chinese
chang	Chinese
chao	Chinese
che	Chinese
chen	Chinese
cheng	Chinese
cheung	Chinese
chew	Chinese
chieu	Chinese
chin	Chinese
chong	Chinese
chou	Chinese
chu	Chinese
cui	Chinese
dai	Chinese
deng	Chinese
ding	Chinese
dong	Chinese
dou	Chinese
duan	Chinese
eng	Chinese
fan	Chinese
fei	Chinese
feng	Chinese
foong	Chinese
fung	Chinese
gan	Chinese
gauk	Chinese
geng	Chinese
gim	Chinese
gok	Chinese
gong	Chinese
guan	Chinese
guang	Chinese
guo	Chinese
gwock	Chinese
han	Chinese
hang	Chinese
hao	Chinese
hew	Chinese
hiu	Chinese
hong	Chinese
hor	Chinese
hsiao	Chinese
hua	Chinese
huan	Chinese
huang	Chinese
hui	Chinese
huie	Chinese
huo	Chinese
jia	Chinese
jiang	Chinese
jin	Chinese
jing	Chinese
joe	Chinese
kang	Chinese
kau	Chinese
khoo	Chinese
khu	Chinese
kong	Chinese
koo	Chinese
kwan	Chinese
kwei	Chinese
kwong	Chinese
lai	Chinese
lam	Chinese
lang	Chinese
lau	Chinese
law	Chinese
lew	Chinese
lian	Chinese
liao	Chinese
lim	Chinese
lin	Chinese
ling	Chinese
liu	Chinese
loh	Chinese
long	Chinese
loong	Chinese
luo	Chinese
mah	Chinese
mai	Chinese
mak	Chinese
mao	Chinese
mar	Chinese
mei	Chinese
meng	Chinese
miao	Chinese
min	Chinese
ming	Chinese
moy	Chinese
mui	Chinese
nie	Chinese
niu	Chinese
ouyang	Chinese
owyang	Chinese
pan	Chinese
pang	Chinese
pei	Chinese
peng	Chinese
ping	Chinese
qian	Chinese
qin	Chinese
qiu	Chinese
quan	Chinese
que	Chinese
ran	Chinese
rao	Chinese
rong	Chinese
ruan	Chinese
sam	Chinese
seah	Chinese
see 	Chinese
seow	Chinese
seto	Chinese
sha	Chinese
shan	Chinese
shang	Chinese
shao	Chinese
shaw	Chinese
she	Chinese
shen	Chinese
sheng	Chinese
shi	Chinese
shu	Chinese
shuai	Chinese
shui	Chinese
shum	Chinese
siew	Chinese
siu	Chinese
song	Chinese
sum	Chinese
sun	Chinese
sze 	Chinese
tan	Chinese
tang	Chinese
tao	Chinese
teng	Chinese
teoh	Chinese
thean	Chinese
thian	Chinese
thien	Chinese
tian	Chinese
tong	Chinese
tow	Chinese
tsang	Chinese
tse	Chinese
tsen	Chinese
tso	Chinese
tze	Chinese
wan	Chinese
wang	Chinese
wei	Chinese
wen	Chinese
weng	Chinese
won	Chinese
wong	Chinese
woo	Chinese
xiang	Chinese
xiao	Chinese
xie	Chinese
xing	Chinese
xue	Chinese
xun	Chinese
yan	Chinese
yang	Chinese
yao	Chinese
yap	Chinese
yau	Chinese
yee	Chinese
yep	Chinese
yim	Chinese
yin	Chinese
ying	Chinese
yong	Chinese
you	Chinese
yuan	Chinese
zang	Chinese
zeng	Chinese
zha	Chinese
zhan	Chinese
zhang	Chinese
zhao	Chinese
zhen	Chinese
zheng	Chinese
zhong	Chinese
zhou	Chinese
zhu	Chinese
zhuo	Chinese
zong	Chinese
zou	Chinese
bing	Chinese
chi	Chinese
cong	Chinese
cuan	Chinese
dan	Chinese
gai	Chinese
gao	Chinese
gou	Chinese
gui	Chinese
hou	Chinese
jian	Chinese
jiao	Chinese
jiu	Chinese
juan	Chinese
jue	Chinese
kan	Chinese
kuai	Chinese
kuang	Chinese
kui	Chinese
lao	Chinese
liang	Chinese
lu	Chinese
man	Chinese
nao	Chinese
pian	Chinese
qiao	Chinese
qing	Chinese
rang	Chinese
rui	Chinese
shuo	Chinese
sui	Chinese
tai	Chinese
xian	Chinese
xin	Chinese
xiong	Chinese
xuan	Chinese
yue	Chinese
yun	Chinese
zhai	Chinese
zhi	Chinese
zhuan	Chinese
zhui	Chinese
abbas	English
abbey	English
abbott	English
abdi	English
abel	English
abraham	English
abrahams	English
abrams	English
ackary	English
ackroyd	English
acton	English
adair	English
adam	English
adams	English
adamson	English
adanet	English
addams	English
adderley	English
addinall	English
addis	English
addison	English
addley	English
aderson	English
adey	English
adkins	English
adlam	English
adler	English
adrol	English
adsett	English
agar	English
ahern	English
aherne	English
ahmad	English
ahmed	English
aikman	English
ainley	English
ainsworth	English
aird	English
airey	English
aitchison	English
aitken	English
akhtar	English
akram	English
alam	English
alanson	English
alber	English
albert	English
albrighton	English
albutt	English
alcock	English
alden	English
alder	English
aldersley	English
alderson	English
aldred	English
aldren	English
aldridge	English
aldworth	English
alesbury	English
alexandar	English
alexander	English
alexnader	English
alford	English
algar	English
ali	English
alker	English
alladee	English
allam	English
allan	English
allard	English
allaway	English
allcock	English
allcott	English
alldridge	English
alldritt	English
allen	English
allgood	English
allington	English
alliott	English
allison	English
allkins	English
allman	English
allport	English
allsop	English
allum	English
allwood	English
almond	English
alpin	English
alsop	English
altham	English
althoff	English
alves	English
alvey	English
alway	English
ambrose	English
amesbury	English
amin	English
amner	English
amod	English
amor	English
amos	English
anakin	English
anderson	English
andersson	English
anderton	English
andrew	English
andrews	English
angus	English
anker	English
anley	English
annan	English
anscombe	English
ansell	English
anstee	English
anthony	English
antic	English
anton	English
antony	English
antram	English
anwar	English
appleby	English
appleton	English
appleyard	English
apsley	English
arah	English
archer	English
ardern	English
arkins	English
armer	English
armitage	English
armour	English
armsden	English
armstrong	English
arnall	English
arnett	English
arnold	English
arnott	English
arrowsmith	English
arscott	English
arthur	English
artliff	English
ashbridge	English
ashbrook	English
ashby	English
ashcroft	English
ashdown	English
ashe	English
asher	English
ashford	English
ashley	English
ashman	English
ashton	English
ashurst	English
ashwell	English
ashworth	English
askew	English
aslam	English
asom	English
aspey	English
aspin	English
aspinall	English
astbury	English
astle	English
astley	English
aston	English
atherley	English
atherstone	English
atherton	English
atkin	English
atkins	English
atkinson	English
attard	English
atter	English
atterbury	English
atterton	English
attewell	English
attrill	English
attwood	English
auberton	English
auborn	English
aubrey	English
austen	English
austin	English
auton	English
avenue	English
avery	English
aves	English
avis	English
awad	English
axon	English
aylett	English
ayley	English
ayliffe	English
ayling	English
aylott	English
aylward	English
ayres	English
ayton	English
aziz	English
bacon	English
bailey	English
bain	English
bainbridge	English
baines	English
bains	English
baird	English
baker	English
baldwin	English
bale	English
ball	English
ballantyne	English
ballard	English
bamford	English
bancroft	English
banks	English
banner	English
bannister	English
barber	English
barclay	English
barker	English
barlow	English
barnard	English
barnes	English
barnett	English
baron	English
barr	English
barrett	English
barron	English
barrow	English
barry	English
bartlett	English
barton	English
bass	English
bassett	English
batchelor	English
bate	English
bateman	English
bates	English
batt	English
batten	English
batty	English
baxter	English
bayliss	English
beadle	English
beal	English
beale	English
beamish	English
bean	English
bear	English
beattie	English
beatty	English
beaumont	English
beck	English
bedford	English
beech	English
beer	English
begum	English
bell	English
bellamy	English
benfield	English
benjamin	English
bennett	English
benson	English
bentley	English
berger	English
bernard	English
berry	English
best	English
bethell	English
betts	English
bevan	English
beveridge	English
bickley	English
biddle	English
biggs	English
bill	English
bing	English
bingham	English
binnington	English
birch	English
bird	English
bishop	English
bithell	English
black	English
blackburn	English
blackman	English
blackmore	English
blackwell	English
blair	English
blake	English
blakeley	English
blakey	English
blanchard	English
bland	English
bloggs	English
bloom	English
blundell	English
blythe	English
bob	English
boden	English
boland	English
bolton	English
bond	English
bone	English
bonner	English
boon	English
booth	English
borland	English
bostock	English
boulton	English
bourne	English
bouvet	English
bowden	English
bowen	English
bower	English
bowers	English
bowes	English
bowler	English
bowles	English
bowman	English
boyce	English
boyd	English
boyle	English
bracey	English
bradbury	English
bradley	English
bradshaw	English
brady	English
brain	English
braithwaite	English
bramley	English
brandrick	English
bray	English
breen	English
brelsford	English
brennan	English
brett	English
brewer	English
bridges	English
briggs	English
bright	English
bristow	English
britton	English
broadbent	English
broadhurst	English
broadley	English
brock	English
brook	English
brooke	English
brooker	English
brookes	English
brookfield	English
brooks	English
broomfield	English
broughton	English
brown	English
browne	English
browning	English
bruce	English
brunet	English
brunton	English
bryan	English
bryant	English
bryson	English
buchan	English
buchanan	English
buck	English
buckingham	English
buckley	English
budd	English
bugg	English
bull	English
bullock	English
burch	English
burden	English
burdett	English
burford	English
burge	English
burgess	English
burke	English
burland	English
burman	English
burn	English
burnett	English
burns	English
burr	English
burrows	English
burt	English
burton	English
busby	English
bush	English
butcher	English
butler	English
butt	English
butter	English
butterworth	English
button	English
buxton	English
byrne	English
caddy	English
cadman	English
cahill	English
cain	English
cairns	English
caldwell	English
callaghan	English
callow	English
calveley	English
calvert	English
cameron	English
campbell	English
cann	English
cannon	English
caplan	English
capper	English
carey	English
carling	English
carmichael	English
carnegie	English
carney	English
carpenter	English
carr	English
carrington	English
carroll	English
carruthers	English
carson	English
carter	English
cartwright	English
carty	English
casey	English
cashmore	English
cassidy	English
caton	English
cavanagh	English
cawley	English
chadwick	English
chalmers	English
chamberlain	English
chambers	English
chan	English
chance	English
chandler	English
chantler	English
chaplin	English
chapman	English
chappell	English
chapple	English
charge	English
charles	English
charlton	English
charnock	English
chase	English
chatterton	English
chauhan	English
cheetham	English
chelmy	English
cherry	English
cheshire	English
chester	English
cheung	English
chidlow	English
child	English
childs	English
chilvers	English
chisholm	English
chong	English
christie	English
christy	English
chung	English
church	English
churchill	English
clamp	English
clancy	English
clark	English
clarke	English
clarkson	English
clay	English
clayton	English
cleary	English
cleaver	English
clegg	English
clements	English
cliff	English
clifford	English
clifton	English
close	English
clough	English
clowes	English
coates	English
coburn	English
cochrane	English
cockburn	English
cockle	English
coffey	English
cohen	English
cole	English
coleman	English
coles	English
coll	English
collard	English
collett	English
colley	English
collier	English
collingwood	English
collins	English
collinson	English
colman	English
compton	English
conneely	English
connell	English
connelly	English
connolly	English
connor	English
conrad	English
conroy	English
conway	English
cook	English
cooke	English
cookson	English
coomber	English
coombes	English
cooper	English
cope	English
copeland	English
copland	English
copley	English
corbett	English
corcoran	English
core	English
corlett	English
cormack	English
corner	English
cornish	English
cornock	English
corr	English
corrigan	English
cosgrove	English
costa	English
costello	English
cotter	English
cotterill	English
cotton	English
cottrell	English
couch	English
coulson	English
coulter	English
court	English
cousin	English
cousins	English
cove	English
cowan	English
coward	English
cowell	English
cowie	English
cowley	English
cox	English
coyle	English
crabb	English
crabtree	English
cracknell	English
craig	English
crane	English
craven	English
crawford	English
crawley	English
creasey	English
cresswell	English
crew	English
cripps	English
crisp	English
crocker	English
croft	English
crofts	English
cronin	English
crook	English
crosby	English
cross	English
crossland	English
crossley	English
crouch	English
croucher	English
crow	English
crowe	English
crowley	English
crown	English
crowther	English
crump	English
cullen	English
cumming	English
cummings	English
cummins	English
cunningham	English
curley	English
curran	English
currie	English
curry	English
curtis	English
curwood	English
cutts	English
d arcy	English
dacey	English
dack	English
dalby	English
dale	English
daley	English
dallas	English
dalton	English
daly	English
dalzell	English
damon	English
danby	English
dandy	English
daniel	English
daniells	English
daniels	English
danks	English
dann	English
darby	English
darbyshire	English
darcy	English
dardenne	English
darlington	English
darr	English
daugherty	English
davenport	English
davey	English
david	English
davidson	English
davie	English
davies	English
davis	English
davison	English
davy	English
dawe	English
dawes	English
dawkins	English
dawson	English
day	English
dayman	English
de ath	English
deacon	English
deakin	English
dean	English
deane	English
deans	English
debenham	English
deegan	English
deeley	English
deighton	English
delamarre	English
delaney	English
dell	English
dempsey	English
dempster	English
denby	English
denham	English
denis	English
denney	English
dennis	English
dent	English
denton	English
depp	English
dermody	English
derrick	English
derrien	English
dervish	English
desai	English
devaney	English
devenish	English
deverell	English
devine	English
devlin	English
devon	English
devonport	English
dewar	English
dexter	English
diamond	English
dibble	English
dick	English
dickens	English
dickenson	English
dicker	English
dickinson	English
dickson	English
dillon	English
dimmock	English
dingle	English
dipper	English
dixon	English
dobbin	English
dobbins	English
doble	English
dobson	English
docherty	English
docker	English
dodd	English
dodds	English
dodson	English
doherty	English
dolan	English
dolcy	English
dolman	English
dolton	English
donald	English
donaldson	English
donkin	English
donlan	English
donn	English
donnachie	English
donnelly	English
donoghue	English
donohoe	English
donovan	English
dooley	English
doolin	English
doon	English
doors	English
dora	English
doran	English
dorman	English
dornan	English
dorrian	English
dorrington	English
dougal	English
dougherty	English
doughty	English
douglas	English
douthwaite	English
dove	English
dover	English
dowell	English
dowler	English
dowling	English
down	English
downer	English
downes	English
downey	English
downie	English
downing	English
downs	English
downton	English
dowson	English
doyle	English
drabble	English
drain	English
drake	English
draper	English
drew	English
drewett	English
dreyer	English
driffield	English
drinkwater	English
driscoll	English
driver	English
drummond	English
drury	English
drysdale	English
dubois	English
duck	English
duckworth	English
ducon	English
dudley	English
duff	English
duffield	English
duffin	English
duffy	English
dufour	English
duggan	English
duke	English
dukes	English
dumont	English
duncan	English
dundon	English
dunford	English
dunkley	English
dunlop	English
dunmore	English
dunn	English
dunne	English
dunnett	English
dunning	English
dunsford	English
dupont	English
durand	English
durant	English
durber	English
durham	English
durrant	English
dutt	English
duval	English
duvall	English
dwyer	English
dyde	English
dyer	English
dyerson	English
dykes	English
dymond	English
dymott	English
dyson	English
eade	English
eadie	English
eagle	English
eales	English
ealham	English
ealy	English
eames	English
eansworth	English
earing	English
earl	English
earle	English
earley	English
easdale	English
easdown	English
easen	English
eason	English
east	English
eastaugh	English
eastaway	English
eastell	English
easterbrook	English
eastham	English
easton	English
eastwood	English
eatherington	English
eaton	English
eaves	English
ebbs	English
ebden	English
ebdon	English
ebeling	English
eburne	English
eccles	English
eccleston	English
ecclestone	English
eccott	English
eckersall	English
eckersley	English
eddison	English
eddleston	English
eddy	English
eden	English
edeson	English
edgar	English
edge	English
edgell	English
edgerton	English
edgley	English
edgson	English
edkins	English
edler	English
edley	English
edlington	English
edmond	English
edmonds	English
edmondson	English
edmunds	English
edmundson	English
edney	English
edon	English
edwards	English
edwick	English
eedie	English
egan	English
egerton	English
eggby	English
eggison	English
eggleston	English
eglan	English
egleton	English
eglin	English
eilers	English
ekin	English
elbutt	English
elcock	English
elder	English
eldeston	English
eldridge	English
eley	English
elfman	English
elford	English
elkin	English
elkington	English
ellam	English
ellans	English
ellard	English
elleray	English
ellerby	English
ellershaw	English
ellery	English
elliman	English
elling	English
ellingham	English
elliot	English
elliott	English
ellis	English
ellison	English
elliston	English
ellrott	English
ellwood	English
elmer	English
elmes	English
elmhirst	English
elmore	English
elms	English
elphick	English
elsdon	English
elsmore	English
elson	English
elston	English
elstone	English
eltis	English
elven	English
elvin	English
elvins	English
elwell	English
elwood	English
elworthy	English
elzer	English
emberey	English
emberson	English
embleton	English
emerick	English
emerson	English
emery	English
emmanuel	English
emmerson	English
emmery	English
emmett	English
emmings	English
emmins	English
emmons	English
emmott	English
emms	English
emsden	English
endroe	English
england	English
english	English
ennis	English
ennos	English
enright	English
enticott	English
entwistle	English
epsom	English
epton	English
ernest	English
erridge	English
errington	English
errity	English
esan	English
escott	English
eskins	English
eslick	English
espley	English
essam	English
essan	English
essop	English
estlick	English
etchells	English
etheridge	English
etherington	English
etherton	English
ettrick	English
evans	English
evason	English
evenden	English
everdell	English
everett	English
everill	English
everitt	English
everson	English
everton	English
eveson	English
evison	English
evrard	English
ewart	English
ewin	English
ewing	English
ewles	English
exley	English
exon	English
exton	English
eyett	English
eyles	English
eyre	English
eyres	English
fabb	English
fagan	English
fagon	English
fahy	English
fairbairn	English
fairbrace	English
fairbrother	English
fairchild	English
fairclough	English
fairhurst	English
fairley	English
fairlie	English
fairweather	English
falconer	English
falk	English
fall	English
fallon	English
fallows	English
falsh	English
farge	English
fargher	English
farhall	English
farley	English
farmer	English
farnsworth	English
farnum	English
farnworth	English
farr	English
farrant	English
farrar	English
farre	English
farrell	English
farrelly	English
farren	English
farrer	English
farrier	English
farrington	English
farrow	English
faulkner	English
faust	English
fawcett	English
fawn	English
faye	English
fearn	English
fearnley	English
fearns	English
fearon	English
featherstone	English
feeney	English
feetham	English
felix	English
fell	English
fellmen	English
fellows	English
feltham	English
felton	English
fenlon	English
fenn	English
fenton	English
fenwick	English
ferdinand	English
fereday	English
ferguson	English
fern	English
fernandez	English
ferns	English
fernyhough	English
ferreira	English
ferrier	English
ferris	English
ferry	English
fewtrell	English
field	English
fielder	English
fielding	English
fields	English
fifield	English
finan	English
finbow	English
finch	English
findlay	English
findley	English
finlay	English
finn	English
finnegan	English
finney	English
finnigan	English
finnimore	English
firth	English
fischer	English
fish	English
fisher	English
fishlock	English
fisk	English
fitch	English
fitchett	English
fitton	English
fitzgerald	English
fitzpatrick	English
fitzsimmons	English
flack	English
flaherty	English
flanagan	English
flanders	English
flannery	English
flavell	English
flaxman	English
fleetwood	English
fleming	English
fletcher	English
flett	English
florey	English
floss	English
flower	English
flowers	English
floyd	English
flynn	English
foden	English
fogg	English
foley	English
fontaine	English
foran	English
forbes	English
ford	English
forde	English
fordham	English
foreman	English
forester	English
forman	English
forrest	English
forrester	English
forshaw	English
forster	English
forsyth	English
forsythe	English
forth	English
fortin	English
foss	English
fossard	English
fosse	English
foster	English
foston	English
fothergill	English
fotheringham	English
foucher	English
foulkes	English
fountain	English
fowler	English
fowley	English
fox	English
foxall	English
foxley	English
frame	English
frampton	English
france	English
francis	English
franco	English
frankish	English
frankland	English
franklin	English
franks	English
frary	English
fraser	English
frazer	English
frederick	English
frederikson	English
freeburn	English
freedman	English
freeman	English
freestone	English
freeth	English
freight	English
french	English
fretwell	English
frey	English
fricker	English
friel	English
friend	English
frith	English
froggatt	English
froggett	English
frost	English
frostick	English
froy	English
frusher	English
fryer	English
fulker	English
fuller	English
fulleron	English
fullerton	English
fulton	English
funnell	English
furey	English
furlong	English
furnell	English
furness	English
furnish	English
furniss	English
furse	English
fyall	English
gadsden	English
gaffney	English
galbraith	English
gale	English
gales	English
gall	English
gallacher	English
gallagher	English
galliford	English
gallo	English
galloway	English
galvin	English
gamble	English
gammer	English
gammon	English
gander	English
gandham	English
ganivet	English
garber	English
garbett	English
garbutt	English
garcia	English
gardener	English
gardiner	English
gardner	English
garland	English
garner	English
garrard	English
garratt	English
garrett	English
garside	English
garvey	English
gascoyne	English
gaskell	English
gately	English
gates	English
gaudin	English
gaumont	English
gauntlett	English
gavin	English
gaynor	English
geaney	English
geary	English
geeson	English
geldard	English
geldart	English
gell	English
gemmell	English
gene	English
george	English
gerard	English
gerrard	English
geyer	English
gibb	English
gibbins	English
gibbon	English
gibbons	English
gibbs	English
giblin	English
gibson	English
gifford	English
gilbert	English
gilbey	English
gilchrist	English
gilder	English
giles	English
gilfillan	English
gilks	English
gill	English
gillam	English
gillan	English
gillard	English
gillen	English
gillespie	English
gillett	English
gillies	English
gilmartin	English
gilmore	English
gilmour	English
ginty	English
girdwood	English
girling	English
given	English
gladwell	English
glaister	English
glasby	English
glasgow	English
glass	English
gleave	English
gledhill	English
gleeson	English
glen	English
glencross	English
glenn	English
glennie	English
glennon	English
glew	English
glossop	English
glover	English
glynn	English
goble	English
godby	English
goddard	English
godden	English
godfrey	English
godwin	English
goff	English
gold	English
goldberg	English
golding	English
goldman	English
goldsmith	English
goldsworthy	English
gomez	English
gonzalez	English
gooch	English
good	English
goodacre	English
goodall	English
goodchild	English
goode	English
gooding	English
goodman	English
goodridge	English
goodson	English
goodwin	English
goodyear	English
gordon	English
goring	English
gorman	English
gosden	English
gosling	English
gough	English
gould	English
goulden	English
goulding	English
gourlay	English
govender	English
govier	English
gower	English
gowing	English
grady	English
graham	English
grainger	English
grange	English
granger	English
grant	English
graves	English
gray	English
grayson	English
greaves	English
green	English
greenall	English
greenaway	English
greene	English
greener	English
greenhill	English
greening	English
greenleaf	English
greenshields	English
greenslade	English
greensmith	English
greenway	English
greenwood	English
greer	English
gregory	English
greig	English
grenard	English
grennan	English
gresham	English
grey	English
grierson	English
griff	English
griffin	English
griffith	English
griffiths	English
griggs	English
grimes	English
grimshaw	English
grinham	English
grivet	English
grogan	English
groom	English
grose	English
grosvenor	English
grout	English
groves	English
grundy	English
guest	English
guilmard	English
guinard	English
gulley	English
gunby	English
gunn	English
gunning	English
gunston	English
gunter	English
guthrie	English
gutteridge	English
guttridge	English
hackett	English
hadden	English
haddock	English
hadfield	English
hagan	English
haggett	English
haigh	English
haine	English
haines	English
hale	English
halford	English
hall	English
hallam	English
hallett	English
halliday	English
halliwell	English
halstead	English
hamer	English
hamill	English
hamilton	English
hammond	English
hamnett	English
hampson	English
hampton	English
hancock	English
hand	English
handley	English
hanlon	English
hannam	English
hansen	English
hanson	English
harden	English
harding	English
hardwick	English
hardy	English
hargreaves	English
harker	English
harkness	English
harley	English
harlow	English
harman	English
harness	English
harper	English
harries	English
harrington	English
harris	English
harrison	English
harrop	English
harry	English
hart	English
hartley	English
harvey	English
harwood	English
haslam	English
hassan	English
hassani	English
hastings	English
hatch	English
hatton	English
hawes	English
hawker	English
hawkes	English
hawkins	English
hawkridge	English
hawley	English
haworth	English
hawtin	English
hayes	English
haynes	English
hayward	English
head	English
healey	English
healy	English
heath	English
heathcote	English
heather	English
heatley	English
heaton	English
hedley	English
hegney	English
helley	English
hellier	English
helm	English
hemingway	English
hemmings	English
henderson	English
hendry	English
heneghan	English
hennessy	English
henry	English
hepburn	English
hepples	English
herbert	English
heritage	English
heron	English
herron	English
hetherington	English
hewitt	English
hewlett	English
heywood	English
hibbert	English
hickey	English
hickman	English
hicks	English
higgins	English
higginson	English
higgs	English
hill	English
hills	English
hilton	English
hind	English
hinde	English
hindle	English
hindley	English
hinds	English
hine	English
hinton	English
hirst	English
hiscocks	English
hitchcock	English
hoare	English
hobbs	English
hobson	English
hocking	English
hodder	English
hodge	English
hodges	English
hodgkins	English
hodgkinson	English
hodgson	English
hodkinson	English
hodson	English
hogan	English
hogg	English
holden	English
holder	English
holding	English
holdsworth	English
hole	English
holgate	English
holl	English
holland	English
hollis	English
holloway	English
holman	English
holmes	English
holt	English
homer	English
hood	English
hook	English
hooper	English
hooton	English
hope	English
hopes	English
hopkins	English
hopkinson	English
hopwood	English
horn	English
horne	English
horner	English
horrocks	English
horton	English
hough	English
houghton	English
hoult	English
houlton	English
houston	English
howard	English
howarth	English
howden	English
howe	English
howell	English
howells	English
howes	English
howie	English
hoyle	English
hubbard	English
hudson	English
huggins	English
hughes	English
hull	English
hulme	English
hume	English
humphrey	English
humphreys	English
humphries	English
hunt	English
hunter	English
hurley	English
hurrell	English
hurst	English
hussain	English
hussein	English
hussey	English
hutchings	English
hutchins	English
hutchinson	English
hutchison	English
hutton	English
hyde	English
ianson	English
ibbotson	English
ibbs	English
ibrahim	English
iddon	English
iggleden	English
iles	English
ilett	English
illing	English
illingworth	English
ilsley	English
impey	English
imran	English
ingermann	English
ingham	English
ingle	English
ingleby	English
ingledew	English
inglefield	English
ingles	English
inglethorpe	English
ingram	English
inker	English
inman	English
innalls	English
innes	English
inson	English
ireland	English
ireson	English
ironman	English
ironmonger	English
irvin	English
irvine	English
irving	English
irwin	English
isaac	English
isaacs	English
isbill	English
isbitt	English
isgate	English
isherwod	English
isherwood	English
islam	English
isman	English
isnard	English
issac	English
ivory	English
izzard	English
jackman	English
jacks	English
jackson	English
jacob	English
jacobs	English
jacobson	English
jacques	English
jaffray	English
jagger	English
jakeman	English
james	English
jameson	English
jamieson	English
janes	English
jansen	English
jardine	English
jarman	English
jarram	English
jarratt	English
jarrett	English
jarrold	English
jarvis	English
jasper	English
jebson	English
jeffcock	English
jefferies	English
jeffers	English
jefferson	English
jeffery	English
jefford	English
jeffrey	English
jeffreys	English
jeffries	English
jeffs	English
jems	English
jenas	English
jenkin	English
jenkins	English
jenkinson	English
jenks	English
jenkyns	English
jenner	English
jennings	English
jennison	English
jennson	English
jensen	English
jepson	English
jermy	English
jerome	English
jerry	English
jervis	English
jesson	English
jessop	English
jevons	English
jewell	English
jewers	English
jewett	English
jewitt	English
jewkes	English
jewson	English
jiggens	English
jobson	English
johannson	English
johansen	English
johanson	English
john	English
johns	English
johnson	English
johnston	English
johnstone	English
jolley	English
jolly	English
jonas	English
jones	English
jonhson	English
jopson	English
jordan	English
jordison	English
jordon	English
joseph	English
joss	English
jourdan	English
jowett	English
jowitt	English
joyce	English
joynson	English
jubb	English
judd	English
judge	English
jukes	English
jupp	English
jury	English
kacy	English
kaddour	English
kamara	English
kampfner	English
kane	English
kanes	English
kapoor	English
karim	English
karne	English
karras	English
kassell	English
kaufman	English
kaul	English
kaur	English
kavanagh	English
kay	English
kaye	English
kayes	English
keable	English
keal	English
kealey	English
keane	English
kearney	English
kearns	English
kearsley	English
kearton	English
keating	English
keaveney	English
keay	English
keeble	English
keefe	English
keegan	English
keelan	English
keeler	English
keeley	English
keeling	English
keenan	English
keene	English
keetley	English
keffler	English
kehoe	English
keighley	English
keight	English
keilty	English
keir	English
keith	English
kelk	English
kell	English
kelland	English
kellems	English
kellie	English
kelliher	English
kelly	English
kelsall	English
kelsey	English
kelso	English
kemp	English
kempson	English
kempster	English
kendall	English
kendell	English
kendrick	English
kenley	English
kennard	English
kennedy	English
kenneford	English
kennell	English
kenneth	English
kennett	English
kenney	English
kenning	English
kenny	English
kenrick	English
kensington	English
kent	English
kentwood	English
kenward	English
kenworthy	English
kenyon	English
keogh	English
kerby	English
kernick	English
kerr	English
kerrell	English
kerridge	English
kerrigan	English
kerrighen	English
kerrison	English
kershaw	English
ketley	English
kett	English
kettell	English
ketteringham	English
kettlewell	English
keward	English
kewley	English
keys	English
keyte	English
keywood	English
khalid	English
khalifa	English
khalil	English
khan	English
kibblewhite	English
kidd	English
kiddle	English
kidman	English
kidner	English
kiely	English
kiernan	English
kilb	English
kilbee	English
kilbey	English
kilbride	English
kilburn	English
kilford	English
kill	English
killeen	English
killen	English
killick	English
killock	English
kilminster	English
kilmurry	English
kilnan	English
kilner	English
kilroy	English
kilshaw	English
kimber	English
kimble	English
kinch	English
kinchin	English
kinder	English
king	English
kingdon	English
kinghorn	English
kingman	English
kings	English
kingscott	English
kingsley	English
kingston	English
kinnaird	English
kinnear	English
kinnersley	English
kinniburgh	English
kinnison	English
kinrade	English
kinsella	English
kinsey	English
kinsley	English
kipling	English
kirby	English
kirk	English
kirkbride	English
kirkbright	English
kirkby	English
kirkland	English
kirkman	English
kirkpatrick	English
kirkwood	English
kirtley	English
kirwan	English
kirwin	English
kitchen	English
kitchin	English
kitching	English
kitson	English
kitt	English
klam	English
klein	English
knab	English
knappett	English
knibb	English
knigge	English
knight	English
knightley	English
knighton	English
knights	English
knott	English
knowler	English
knowles	English
knox	English
knoxville	English
knuckles	English
knutt	English
koban	English
kolt	English
kone	English
kore	English
kouma	English
kram	English
kreyling	English
kristensen	English
kromberg	English
kruger	English
kumar	English
kurian	English
kurray	English
kydd	English
kyle	English
kysel	English
labbe	English
lacey	English
lacy	English
laing	English
laird	English
lake	English
lakey	English
lakin	English
lamb	English
lambert	English
lambton	English
lame	English
lamond	English
lancaster	English
lander	English
lane	English
lang	English
langdon	English
lange	English
langford	English
langley	English
langridge	English
langston	English
langton	English
lanham	English
laraway	English
large	English
larkin	English
larkings	English
larsen	English
larsson	English
last	English
latham	English
lathan	English
lathey	English
lattimore	English
laurie	English
laver	English
laverick	English
lavery	English
lawal	English
lawler	English
lawlor	English
lawn	English
lawrance	English
lawrence	English
lawrie	English
laws	English
lawson	English
lawther	English
lawton	English
laycock	English
layton	English
le tissier	English
leach	English
leadley	English
leahy	English
leake	English
leal	English
leary	English
leaver	English
leck	English
leckie	English
ledger	English
lee	English
leech	English
leedham	English
leek	English
leeming	English
lees	English
leese	English
leeson	English
legg	English
legge	English
leggett	English
leigh	English
leighton	English
leitch	English
leith	English
lendon	English
lenihan	English
lennard	English
lennon	English
lennox	English
leonard	English
leroy	English
leslie	English
lester	English
lethbridge	English
levann	English
levett	English
levin	English
levine	English
levy	English
lewin	English
lewington	English
lewins	English
lewis	English
lewry	English
leyland	English
leys	English
leyshon	English
liddell	English
liddle	English
lightfoot	English
lilley	English
lilly	English
lilwall	English
lincoln	English
lind	English
linden	English
lindo	English
lindop	English
lindsay	English
line	English
lines	English
linford	English
ling	English
linley	English
linsby	English
linton	English
lister	English
litchfield	English
little	English
littlewood	English
livermore	English
livingstone	English
llewellyn	English
lloyd	English
loat	English
lobb	English
lock	English
locke	English
lockett	English
lockhart	English
lockie	English
lockwood	English
lockyer	English
lodge	English
loft	English
lofthouse	English
loftus	English
logan	English
lohan	English
lois	English
lomas	English
lomax	English
london	English
long	English
longhurst	English
longley	English
longworth	English
lonsdale	English
lopes	English
lopez	English
lord	English
loudon	English
loughran	English
louth	English
lovatt	English
love	English
lovegrove	English
lovell	English
lovelock	English
lovett	English
lovey	English
lowbridge	English
lowdon	English
lowe	English
lowes	English
lowis	English
lowndes	English
lowrie	English
lowry	English
lucas	English
luce	English
lucey	English
luckhurst	English
ludgrove	English
ludkin	English
ludlow	English
luke	English
luker	English
lumb	English
lumley	English
lumsden	English
lunn	English
lunt	English
luscombe	English
luttrell	English
luxton	English
lyall	English
lyes	English
lyme	English
lynas	English
lynch	English
lynes	English
lynn	English
lyon	English
lyons	English
mac	English
macarthur	English
macaulay	English
macdonald	English
mace	English
macfarlane	English
macgregor	English
machin	English
macintyre	English
mack	English
mackay	English
mackenzie	English
mackie	English
maclean	English
macleod	English
macmillan	English
macpherson	English
macrae	English
madden	English
maddocks	English
magee	English
maguire	English
maher	English
mahoney	English
main	English
mair	English
major	English
makin	English
malley	English
mallinson	English
malone	English
maloney	English
mangnall	English
mann	English
manning	English
mansell	English
mansfield	English
manson	English
markham	English
marks	English
marlow	English
marr	English
marriott	English
marsden	English
marsh	English
marshall	English
martin	English
martinez	English
martins	English
mason	English
masters	English
mather	English
mathers	English
matheson	English
mathews	English
matthams	English
matthews	English
maughan	English
mawson	English
maxwell	English
may	English
maynard	English
mcarthur	English
mcauley	English
mcavoy	English
mcbain	English
mccabe	English
mccaffrey	English
mccall	English
mccallum	English
mccann	English
mccarthy	English
mccartney	English
mccluskey	English
mcclymont	English
mcconnell	English
mccormack	English
mccormick	English
mccourt	English
mcculloch	English
mccullough	English
mcdermott	English
mcdonagh	English
mcdonald	English
mcdonnell	English
mcdougall	English
mcelroy	English
mcewan	English
mcfadden	English
mcfarlane	English
mcgee	English
mcghee	English
mcgill	English
mcginty	English
mcgowan	English
mcgrady	English
mcgrath	English
mcgregor	English
mcgrory	English
mcguinness	English
mcguire	English
mcintosh	English
mcintyre	English
mckay	English
mckee	English
mckenna	English
mckenzie	English
mckeown	English
mckie	English
mclaren	English
mclaughlin	English
mclean	English
mclellan	English
mcleod	English
mcloughlin	English
mcmahon	English
mcmanus	English
mcmillan	English
mcnally	English
mcnamara	English
mcnaught	English
mcneil	English
mcneill	English
mcnulty	English
mcphail	English
mcphee	English
mcpherson	English
mcrae	English
mcshane	English
mctaggart	English
meadows	English
meakin	English
mears	English
melia	English
mellor	English
meredith	English
merritt	English
metcalf	English
metcalfe	English
michael	English
michel	English
middleton	English
miles	English
milford	English
mill	English
millar	English
millard	English
miller	English
millett	English
milligan	English
millington	English
mills	English
millward	English
milne	English
milner	English
milward	English
mistry	English
mitchell	English
moffat	English
mohamed	English
mohammed	English
molloy	English
molyneux	English
monaghan	English
montague	English
montgomery	English
moody	English
moon	English
mooney	English
moore	English
moorhouse	English
moran	English
more	English
moreno	English
moreton	English
morgan	English
moriarty	English
morley	English
moroney	English
morris	English
morrison	English
morrow	English
mortimer	English
morton	English
moseley	English
moss	English
mottram	English
mould	English
muir	English
mullen	English
mulligan	English
mullins	English
mundy	English
munro	English
murphy	English
murray	English
murrell	English
mustafa	English
myatt	English
myers	English
nair	English
nairn	English
nandi	English
nanson	English
nanton	English
napier	English
napper	English
nartey	English
nash	English
nason	English
naughton	English
naumann	English
nayler	English
naylor	English
naysmith	English
neal	English
neale	English
neary	English
neave	English
neaverson	English
nedd	English
needham	English
neeson	English
negros	English
neighbour	English
neill	English
neilsen	English
neilson	English
neish	English
nelmes	English
nelms	English
nelson	English
nemeth	English
nero	English
nesbitt	English
ness	English
nessbert	English
nettleton	English
neville	English
nevins	English
nevis	English
newall	English
newberry	English
newbold	English
newbury	English
newby	English
newcombe	English
newell	English
newey	English
newham	English
newill	English
newington	English
newland	English
newlands	English
newman	English
newsham	English
newsome	English
newson	English
newstead	English
newton	English
neyland	English
nichol	English
nicholas	English
nicholl	English
nicholls	English
nichols	English
nicholson	English
nickel	English
nickolls	English
nicks	English
nicol	English
nicolas	English
nicoll	English
nicolson	English
nield	English
nielsen	English
nielson	English
nightingale	English
niles	English
nilsen	English
nineham	English
nisbet	English
nixon	English
noach	English
noakes	English
nobbs	English
noble	English
noggins	English
nokes	English
nolan	English
nood	English
noon	English
noonan	English
norbert	English
norburn	English
norbury	English
norcross	English
nord	English
norgate	English
norgrove	English
norm	English
norman	English
normington	English
norris	English
norsworthy	English
north	English
northcott	English
norton	English
norville	English
norwood	English
notman	English
nott	English
nourse	English
nova	English
nowak	English
nowell	English
noyce	English
noyes	English
nugent	English
number	English
nunn	English
nurse	English
nurton	English
nutella	English
nutman	English
nutt	English
nuttall	English
oakes	English
oakey	English
oakley	English
oaks	English
oakton	English
oates	English
oatridge	English
oatway	English
obrien	English
ocallaghan	English
oconnell	English
oconnor	English
odam	English
oddie	English
oddy	English
odea	English
odell	English
odling	English
odonnell	English
odonoghue	English
odriscoll	English
oflynn	English
ogden	English
ogilvie	English
ogilvy	English
ogrady	English
ohalloran	English
ohara	English
okeefe	English
okey	English
okten	English
olan	English
oldfield	English
oldham	English
olding	English
oldland	English
oldroyd	English
olds	English
oleary	English
oliver	English
olivier	English
ollerhead	English
olley	English
oloughlin	English
olsen	English
olson	English
omalley	English
oman	English
oneil	English
oneill	English
opayne	English
openshaw	English
oram	English
orbell	English
orchard	English
oreilly	English
oriley	English
orman	English
orme	English
ormiston	English
ormond	English
ormsby	English
ormston	English
orrell	English
orritt	English
orton	English
orvis	English
orwin	English
osborn	English
osborne	English
osman	English
osmond	English
ostcliffe	English
ostler	English
osullivan	English
oswald	English
otoole	English
otten	English
otter	English
ottey	English
ottley	English
otton	English
ould	English
oulton	English
overall	English
overett	English
overfield	English
overing	English
overson	English
overton	English
owen	English
owens	English
owings	English
oxby	English
oxenham	English
oxley	English
oxtoby	English
pack	English
packard	English
packer	English
pagan	English
page	English
paige	English
pailing	English
paine	English
painter	English
paisley	English
palfrey	English
palfreyman	English
palin	English
pallett	English
palmer	English
panesar	English
pankhurst	English
pannell	English
parish	English
park	English
parker	English
parkes	English
parkin	English
parkins	English
parkinson	English
parks	English
parmar	English
parnaby	English
parnell	English
parr	English
parratt	English
parrott	English
parry	English
parsons	English
partington	English
partlett	English
partridge	English
pascoe	English
pasfield	English
paskell	English
passmore	English
patchett	English
patel	English
pateman	English
paterson	English
paton	English
patrick	English
patten	English
patterson	English
pattinson	English
pattison	English
patton	English
paul	English
pavot	English
pawson	English
payne	English
peace	English
peach	English
peacock	English
peake	English
peal	English
peaper	English
pearce	English
pears	English
pearson	English
peat	English
peck	English
pedley	English
peebles	English
peel	English
peers	English
pegg	English
peigne	English
pell	English
pelling	English
pemberton	English
pender	English
pendlebury	English
pendleton	English
penfold	English
penn	English
pennell	English
penney	English
pennington	English
percival	English
pereira	English
perez	English
perkin	English
perkins	English
perks	English
perowne	English
perrett	English
perrin	English
perrins	English
perry	English
peters	English
petersen	English
peterson	English
petrova	English
pett	English
petticrew	English
peyton	English
phelan	English
phelps	English
philip	English
philips	English
phillips	English
philpott	English
phipps	English
phoenix	English
pick	English
pickard	English
pickering	English
pickersgill	English
pickett	English
pickford	English
pickthall	English
picot	English
pierce	English
piercey	English
pierre	English
pigott	English
pike	English
pilkington	English
pillay	English
pinder	English
pine	English
pinkney	English
pinner	English
pinnock	English
pinsmail	English
pipe	English
piper	English
pitcher	English
pitchford	English
pitt	English
pitts	English
plant	English
plastow	English
platt	English
platts	English
pledger	English
plouvin	English
plumb	English
plummer	English
pocock	English
pointer	English
pole	English
pollard	English
pollock	English
polson	English
pomeroy	English
pomphrey	English
pond	English
pooke	English
poole	English
poon	English
pope	English
porter	English
potter	English
potts	English
poulter	English
poulton	English
pounder	English
povey	English
powell	English
power	English
powers	English
powis	English
powles	English
poyser	English
pratt	English
preece	English
prendergast	English
prentice	English
prescott	English
preston	English
prevost	English
price	English
prime	English
prince	English
pringle	English
prior	English
pritchard	English
privett	English
probert	English
procter	English
proctor	English
prosser	English
provan	English
pryor	English
pugh	English
pullen	English
purcell	English
purkis	English
purnell	English
purse	English
purvis	English
putt	English
pyle	English
quigley	English
quinlivan	English
quinn	English
quinnell	English
quinton	English
quirk	English
quirke	English
rackham	English
radcliffe	English
radford	English
radley	English
raeburn	English
rafferty	English
rahman	English
raine	English
rainey	English
rainford	English
ralph	English
ralston	English
ramm	English
rampling	English
ramsay	English
ramsden	English
ramsey	English
rand	English
randall	English
randle	English
ranger	English
rankin	English
ranks	English
rann	English
ransom	English
ranson	English
rapson	English
rashid	English
ratcliffe	English
raval	English
raven	English
ravenscroft	English
rawlings	English
rawlinson	English
rawsthorne	English
raymond	English
rayner	English
read	English
reade	English
reader	English
reading	English
readle	English
readman	English
reardon	English
reasbeck	English
reay	English
redden	English
redding	English
reddy	English
redfern	English
redhead	English
redin	English
redman	English
redmond	English
redwood	English
reed	English
rees	English
reese	English
reeve	English
reeves	English
regan	English
regent	English
rehman	English
reid	English
reilly	English
reisser	English
render	English
renna	English
rennalls	English
rennie	English
renshaw	English
renwick	English
reveley	English
reyes	English
reygan	English
reynolds	English
rhoades	English
rhodes	English
rhys	English
ricci	English
rice	English
rich	English
richards	English
richardson	English
riches	English
richman	English
richmond	English
richter	English
rick	English
rickard	English
rickards	English
rickett	English
ricketts	English
riddell	English
riddle	English
riddler	English
ridge	English
ridgway	English
ridgwell	English
ridle	English
ridley	English
rigby	English
rigg	English
rigley	English
riley	English
ring	English
ripley	English
rippin	English
riseborough	English
ritchie	English
rivers	English
rixon	English
roach	English
robb	English
robbins	English
robe	English
robert	English
roberts	English
robertson	English
robin	English
robins	English
robinson	English
robishaw	English
robotham	English
robson	English
roche	English
rochford	English
rockliffe	English
rodden	English
roden	English
rodger	English
rodgers	English
rodham	English
rodrigues	English
rodriguez	English
rodwell	English
roebuck	English
roff	English
roffey	English
rogan	English
rogers	English
rogerson	English
roles	English
rolfe	English
rollinson	English
roman	English
romans	English
ronald	English
ronflard	English
rook	English
rooke	English
roome	English
rooney	English
rootham	English
roper	English
ropple	English
roscoe	English
rose	English
rosenblatt	English
rosenbloom	English
ross	English
rosser	English
rossi	English
rosso	English
roth	English
rothery	English
rothwell	English
rouse	English
roussel	English
rousset	English
routledge	English
rowan	English
rowe	English
rowland	English
rowlands	English
rowley	English
rowlinson	English
rowson	English
royall	English
royle	English
rudd	English
ruff	English
rugg	English
rumbold	English
rumsey	English
ruscoe	English
rush	English
rushbrooke	English
rushby	English
rushton	English
russel	English
russell	English
russon	English
rust	English
rutherford	English
rutter	English
ryan	English
ryans	English
rycroft	English
ryder	English
sadiq	English
sadler	English
said	English
saleh	English
salisbury	English
sallis	English
salmon	English
salt	English
salter	English
sampson	English
samuel	English
samuels	English
sanchez	English
sanders	English
sanderson	English
sandison	English
sands	English
santos	English
sargent	English
saunders	English
savage	English
saville	English
sawyer	English
saxton	English
sayers	English
schmid	English
schmidt	English
schofield	English
scott	English
searle	English
seddon	English
seer	English
selby	English
sellars	English
sellers	English
senior	English
sewell	English
sexton	English
seymour	English
shackleton	English
shah	English
shakespeare	English
shand	English
shanks	English
shannon	English
sharkey	English
sharma	English
sharp	English
sharpe	English
sharples	English
shaughnessy	English
shaw	English
shea	English
shearer	English
sheehan	English
sheldon	English
shelton	English
shepherd	English
sheppard	English
sheridan	English
sherman	English
sherriff	English
sherry	English
sherwood	English
shields	English
shipley	English
short	English
shotton	English
showell	English
shuttleworth	English
silcock	English
silva	English
simmonds	English
simmons	English
simms	English
simon	English
simons	English
simpson	English
sims	English
sinclair	English
singh	English
singleton	English
sinha	English
sisson	English
sissons	English
skelly	English
skelton	English
skinner	English
skipper	English
slade	English
slater	English
slattery	English
sloan	English
slocombe	English
small	English
smallwood	English
smart	English
smit	English
smith	English
smithson	English
smullen	English
smyth	English
smythe	English
sneddon	English
snell	English
snelling	English
snow	English
snowden	English
snowdon	English
somerville	English
south	English
southern	English
southgate	English
southwick	English
sparkes	English
sparrow	English
spears	English
speed	English
speight	English
spence	English
spencer	English
spicer	English
spiller	English
spinks	English
spooner	English
squire	English
squires	English
stacey	English
stack	English
staff	English
stafford	English
stainton	English
stamp	English
stanfield	English
stanford	English
stanley	English
stannard	English
stanton	English
stark	English
steadman	English
stedman	English
steel	English
steele	English
steer	English
steere	English
stenhouse	English
stephen	English
stephens	English
stephenson	English
sterling	English
stevens	English
stevenson	English
steward	English
stewart	English
stock	English
stocker	English
stockley	English
stoddart	English
stokes	English
stokoe	English
stone	English
stoppard	English
storer	English
storey	English
storr	English
stott	English
stout	English
strachan	English
strange	English
street	English
stretton	English
strickland	English
stringer	English
strong	English
stroud	English
stuart	English
stubbs	English
stuckey	English
sturgess	English
sturrock	English
styles	English
sugden	English
sullivan	English
summers	English
sumner	English
sunderland	English
sutherland	English
sutton	English
swain	English
swales	English
swan	English
swann	English
swanson	English
sweeney	English
sweeting	English
swift	English
sykes	English
sylvester	English
symes	English
symonds	English
taggart	English
tailor	English
tait	English
talbot	English
tallett	English
tamber	English
tang	English
tanner	English
tansey	English
tansley	English
tappin	English
tapping	English
tapscott	English
tarr	English
tarrant	English
tasker	English
tate	English
tatlock	English
tatlow	English
tatnell	English
taurel	English
tayler	English
taylor	English
teague	English
teal	English
teale	English
teasdale	English
tedd	English
telford	English
tell	English
tellis	English
tempest	English
templar	English
temple	English
templeman	English
templeton	English
tennant	English
terry	English
thackeray	English
thackray	English
thake	English
thatcher	English
thelwell	English
thirlwall	English
thirlway	English
thirlwell	English
thistlethwaite	English
thom	English
thomas	English
thomason	English
thompson	English
thoms	English
thomson	English
thonon	English
thorley	English
thorndyke	English
thorne	English
thornes	English
thornhill	English
thornley	English
thornton	English
thorp	English
thorpe	English
thurbon	English
thurgood	English
thurling	English
thurlow	English
thurman	English
thurston	English
tickner	English
tidmarsh	English
tierney	English
till	English
tillett	English
tilley	English
tilson	English
tilston	English
timberlake	English
timmins	English
timms	English
timney	English
timson	English
tindall	English
tindell	English
tinker	English
tinkler	English
tinsley	English
tipping	English
tippins	English
tips	English
tisdall	English
titmarsh	English
titmus	English
titmuss	English
titterington	English
toal	English
tobin	English
tocher	English
todd	English
tohill	English
toland	English
tolley	English
tollis	English
tolmay	English
tomas	English
tombs	English
tomes	English
tomkins	English
tomlin	English
tomlinson	English
tompkin	English
tompkins	English
toms	English
tong	English
tonge	English
tonks	English
tonner	English
toomer	English
toomey	English
topham	English
topley	English
topliss	English
topp	English
torney	English
torrance	English
torrens	English
torres	English
tosh	English
totten	English
toucet	English
tovar	English
tovey	English
towell	English
towers	English
towle	English
townend	English
towns	English
townsend	English
townsley	English
tozer	English
trafford	English
train	English
trainor	English
trattles	English
travers	English
travill	English
travis	English
traynor	English
treble	English
trennery	English
trent	English
treseder	English
trevor	English
trew	English
trickett	English
trigg	English
trimble	English
trinder	English
trollope	English
troon	English
trotman	English
trott	English
trueman	English
truman	English
trump	English
truscott	English
tuck	English
tucker	English
tuckey	English
tudor	English
tuffnell	English
tufnall	English
tugwell	English
tully	English
tunks	English
tunstall	English
turford	English
turke	English
turkington	English
turland	English
turnbull	English
turner	English
turney	English
turnham	English
turnock	English
turrell	English
turton	English
turvey	English
tuthill	English
tuttle	English
tutton	English
tweddle	English
twigg	English
twiggs	English
twine	English
tyler	English
tyman	English
tyne	English
tyrer	English
tyrrell	English
uddin	English
ullman	English
ullmann	English
ulyatt	English
umney	English
underdown	English
underhill	English
underwood	English
unsworth	English
unwin	English
upfield	English
upjohn	English
upsdell	English
upson	English
upton	English
urwin	English
utley	English
utterson	English
uttley	English
utton	English
uttridge	English
vale	English
valentine	English
vallance	English
vallins	English
vallory	English
valmary	English
vancoller	English
vane	English
vann	English
vanstone	English
vanwell	English
vardy	English
varey	English
varley	English
varndell	English
vass	English
vaughan	English
vaughn	English
veale	English
veasey	English
veevers	English
veitch	English
velds	English
venables	English
ventura	English
verdon	English
verell	English
verney	English
vernon	English
vicary	English
vicens	English
vickars	English
vickerman	English
vickers	English
vickery	English
victor	English
vikers	English
villiger	English
villis	English
vince	English
vincent	English
vine	English
viner	English
vines	English
viney	English
vinicombe	English
vinny	English
vinton	English
virgo	English
voakes	English
vockins	English
vodden	English
vollans	English
voyse	English
vyner	English
wade	English
wadham	English
waghorn	English
wagstaff	English
wain	English
wainwright	English
waite	English
wakefield	English
wakeford	English
wakeham	English
wakelin	English
waldron	English
wale	English
wales	English
walkden	English
walker	English
wall	English
wallace	English
waller	English
walling	English
wallis	English
walls	English
walmsley	English
walpole	English
walsh	English
walshe	English
walter	English
walters	English
walton	English
wane	English
wang	English
warburton	English
warby	English
ward	English
warden	English
wardle	English
ware	English
wareing	English
waring	English
warn	English
warner	English
warren	English
warriner	English
warrington	English
warwick	English
water	English
waterfield	English
waterhouse	English
wateridge	English
waterman	English
waters	English
waterson	English
watkins	English
watkinson	English
watling	English
watson	English
watt	English
watters	English
watts	English
waugh	English
wears	English
weasley	English
weaver	English
webb	English
webber	English
webster	English
weeks	English
weir	English
welch	English
weldon	English
weller	English
wellington	English
wellman	English
wells	English
welsh	English
welton	English
were	English
werner	English
werrett	English
west	English
western	English
westgate	English
westlake	English
weston	English
westwell	English
westwood	English
whalley	English
wharton	English
wheatcroft	English
wheatley	English
wheeldon	English
wheeler	English
whelan	English
whitaker	English
whitby	English
white	English
whiteford	English
whitehead	English
whitehouse	English
whitelaw	English
whiteley	English
whitfield	English
whitham	English
whiting	English
whitley	English
whitlock	English
whitmore	English
whittaker	English
whittingham	English
whittington	English
whittle	English
whittley	English
whitworth	English
whyte	English
wickens	English
wickham	English
wicks	English
widdows	English
widdowson	English
wiggins	English
wigley	English
wilcox	English
wild	English
wilde	English
wildman	English
wileman	English
wiles	English
wilkes	English
wilkie	English
wilkin	English
wilkins	English
wilkinson	English
wilks	English
wilkshire	English
will	English
willett	English
willetts	English
williams	English
williamson	English
willis	English
wills	English
willson	English
wilmot	English
wilson	English
wilton	English
wiltshire	English
winder	English
windsor	English
winfer	English
winfield	English
winman	English
winn	English
winship	English
winstanley	English
winter	English
wintersgill	English
winward	English
wise	English
wiseman	English
wither	English
withers	English
wolf	English
wolfe	English
wolstencroft	English
wong	English
wood	English
woodcock	English
woodford	English
woodhall	English
woodham	English
woodhams	English
woodhead	English
woodhouse	English
woodland	English
woodley	English
woods	English
woodward	English
wooldridge	English
woollard	English
woolley	English
woolnough	English
wootton	English
worgan	English
wormald	English
worrall	English
worsnop	English
worth	English
worthington	English
wotherspoon	English
wragg	English
wraight	English
wray	English
wren	English
wrench	English
wrenn	English
wrigglesworth	English
wright	English
wrightson	English
wyatt	English
wyer	English
yabsley	English
yallop	English
yang	English
yapp	English
yard	English
yardley	English
yarker	English
yarlett	English
yarnall	English
yarnold	English
yarwood	English
yasmin	English
yates	English
yeadon	English
yeardley	English
yeardsley	English
yeates	English
yeatman	English
yeldon	English
yeoman	English
yeomans	English
yetman	English
yeung	English
yoman	English
yomkins	English
york	English
yorke	English
yorston	English
youlden	English
young	English
younge	English
younis	English
youssouf	English
yule	English
yusuf	English
zaoui	English
abel	French
abraham	French
adam	French
albert	French
allard	French
archambault	French
armistead	French
arthur	French
augustin	French
babineaux	French
baudin	French
beauchene	French
beaulieu	French
beaumont	French
belanger	French
bellamy	French
bellerose	French
belrose	French
berger	French
beringer	French
bernard	French
bertrand	French
bisset	French
bissette	French
blaise	French
blanc	French
blanchet	French
blanchett	French
bonfils	French
bonheur	French
bonhomme	French
bonnaire	French
bonnay	French
bonner	French
bonnet	French
borde	French
bordelon	French
bouchard	French
boucher	French
brisbois	French
brodeur	French
bureau	French
caron	French
cavey	French
chaput	French
charbonneau	French
charpentier	French
charron	French
chastain	French
chevalier	French
chevrolet	French
cloutier	French
colbert	French
comtois	French
cornett	French
cote	French
coupe	French
courtemanche	French
cousineau	French
couture	French
daniau	French
d'aramitz	French
daviau	French
david	French
deforest	French
degarmo	French
delacroix	French
de la fontaine	French
deniau	French
deniaud	French
deniel	French
denis	French
de sauveterre	French
deschamps	French
descoteaux	French
desjardins	French
desrochers	French
desrosiers	French
dubois	French
duchamps	French
dufort	French
dufour	French
duguay	French
dupond	French
dupont	French
durand	French
durant	French
duval	French
emile	French
eustis	French
fabian	French
fabre	French
fabron	French
faucher	French
faucheux	French
faure	French
favager	French
favre	French
favreau	French
fay	French
felix	French
firmin	French
fontaine	French
forest	French
forestier	French
fortier	French
foss	French
fournier	French
gage	French
gagne	French
gagnier	French
gagnon	French
garcon	French
gardinier	French
germain	French
geroux	French
giles	French
girard	French
giroux	French
glaisyer	French
gosse	French
gosselin	French
granger	French
guerin	French
guillory	French
hardy	French
harman	French
hebert	French
herbert	French
herriot	French
jacques	French
janvier	French
jordan	French
joubert	French
labelle	French
lachance	French
lachapelle	French
lamar	French
lambert	French
lane	French
langlais	French
langlois	French
lapointe	French
larue	French
laurent	French
lavigne	French
lavoie	French
leandres	French
lebeau	French
leblanc	French
leclair	French
leclerc	French
lecuyer	French
lefebvre	French
lefevre	French
lefurgey	French
legrand	French
lemaire	French
lemieux	French
leon	French
leroy	French
lesauvage	French
lestrange	French
leveque	French
levesque	French
linville	French
lyon	French
macon	French
marchand	French
marie	French
marion	French
martel	French
martin	French
masson	French
mathieu	French
mercier	French
merle	French
michaud	French
michel	French
monet	French
monette	French
montagne	French
moreau	French
moulin	French
mullins	French
noel	French
oliver	French
olivier	French
page	French
paget	French
palomer	French
pan	French
pape	French
paquet	French
parent	French
paris	French
parris	French
pascal	French
patenaude	French
paternoster	French
paul	French
pelletier	French
perrault	French
perreault	French
perrot	French
petit	French
pettigrew	French
pierre	French
plamondon	French
plourde	French
poingdestre	French
poirier	French
porcher	French
poulin	French
proulx	French
renaud	French
rey	French
reyer	French
richard	French
richelieu	French
robert	French
roche	French
rome	French
romilly	French
rose	French
rousseau	French
roux	French
roy	French
royer	French
salomon	French
salvage	French
samson	French
samuel	French
sargent	French
sarkozi	French
sarkozy	French
sartre	French
sault	French
sauvage	French
sauvageau	French
sauvageon	French
sauvageot	French
sauveterre	French
savatier	French
segal	French
sergeant	French
severin	French
simon	French
solomon	French
soucy	French
st martin	French
st pierre	French
tailler	French
tasse	French
thayer	French
thibault	French
thomas	French
tobias	French
tolbert	French
traver	French
travere	French
travers	French
traverse	French
travert	French
tremblay	French
tremble	French
victor	French
victors	French
villeneuve	French
vincent	French
vipond	French
voclain	French
yount	French
abbing	German
abel	German
abeln	German
abt	German
achilles	German
achterberg	German
acker	German
ackermann	German
adam	German
adenauer	German
adler	German
adlersflugel	German
aeschelman	German
albert	German
albrecht	German
aleshire	German
aleshite	German
althaus	German
amsel	German
andres	German
armbruster	German
artz	German
aue	German
auer	German
augustin	German
aust	German
autenburg	German
auttenberg	German
baasch	German
bach	German
bachmeier	German
backer	German
bader	German
bahr	German
bambach	German
bauer	German
bauers	German
baum	German
baumann	German
baumbach	German
baumgartner	German
baumhauer	German
bayer	German
beck	German
becke	German
beckenbauer	German
becker	German
beckert	German
behrend	German
behrends	German
beitel	German
beltz	German
benn	German
berg	German
berger	German
bergfalk	German
beringer	German
bernat	German
best	German
beutel	German
beyer	German
beyersdorf	German
bieber	German
biermann	German
bischoffs	German
blau	German
blecher	German
bleier	German
blumenthal	German
blumstein	German
bocker	German
boehler	German
boer	German
boesch	German
bohler	German
bohm	German
bohme	German
bohmer	German
bohn	German
borchard	German
bosch	German
bottcher	German
brahms	German
brand	German
brandt	German
brant	German
brauer	German
braun	German
braune	German
breiner	German
breisacher	German
breitbarth	German
bretz	German
brinkerhoff	German
brodbeck	German
brose	German
brotz	German
bruhn	German
brun	German
brune	German
buchholz	German
buckholtz	German
buhr	German
bumgarner	German
burgstaller	German
busch	German
carver	German
chevrolet	German
cline	German
dahl	German
denzel	German
derrick	German
diefenbach	German
dieter	German
dietrich	German
dirchs	German
dittmar	German
dohman	German
drechsler	German
dreher	German
dreschner	German
dresdner	German
dressler	German
duerr	German
dunkle	German
dunst	German
durr	German
eberhardt	German
ebner	German
eckstein	German
egger	German
eichel	German
eilerts	German
engel	German
enns	German
esser	German
essert	German
everhart	German
fabel	German
faerber	German
falk	German
falkenrath	German
farber	German
fashingbauer	German
faust	German
feigenbaum	German
feld	German
feldt	German
fenstermacher	German
fertig	German
fiedler	German
fischer	German
flater	German
fleischer	German
foerstner	German
forst	German
forstner	German
foth	German
frank	German
franke	German
frei	German
freud	German
freudenberger	German
freund	German
fried	German
friedrich	German
fromm	German
frost	German
fuchs	German
fuhrmann	German
furst	German
fux	German
gabler	German
gaertner	German
garb	German
garber	German
gartner	German
garver	German
gass	German
gehrig	German
gehring	German
geier	German
geiger	German
geisler	German
geissler	German
geiszler	German
gensch	German
gerber	German
gerhard	German
gerhardt	German
gerig	German
gerst	German
gerstle	German
gerver	German
giehl	German
giese	German
glockner	German
goebel	German
goldschmidt	German
gorman	German
gott	German
gotti	German
gottlieb	German
gottschalk	German
graner	German
greenberg	German
groos	German
gros	German
gross	German
gro	German
groe	German
grosse	German
groel	German
groer	German
grosser	German
grosz	German
grunewald	German
gunther	German
gutermuth	German
gwerder	German
haas	German
haase	German
haber	German
habich	German
habicht	German
hafner	German
hahn	German
hall	German
halle	German
harman	German
hartmann	German
hase	German
hasek	German
hasenkamp	German
hass	German
hauer	German
haupt	German
hausler	German
havener	German
heidrich	German
heinrich	German
heinrichs	German
heintze	German
hellewege	German
heppenheimer	German
herbert	German
hermann	German
herrmann	German
herschel	German
hertz	German
hildebrand	German
hinrichs	German
hintzen	German
hirsch	German
hoch	German
hochberg	German
hoefler	German
hofer	German
hoffman	German
hoffmann	German
hofler	German
hofmann	German
hofmeister	German
holst	German
holtzer	German
holzer	German
holzknecht	German
holzmann	German
hoover	German
horn	German
horowitz	German
houk	German
huber	German
huff	German
huffman	German
huffmann	German
hummel	German
hutmacher	German
ingersleben	German
jaeger	German
jager	German
jans	German
janson	German
janz	German
jollenbeck	German
jordan	German
jund	German
jung	German
junge	German
kahler	German
kaiser	German
kalb	German
kalbfleisch	German
kappel	German
karl	German
kaspar	German
kassmeyer	German
kastner	German
katz	German
kaube	German
kaufer	German
kauffmann	German
kaufman	German
keil	German
keller	German
kempf	German
kerner	German
kerper	German
kerwar	German
kerwer	German
kiefer	German
kirchner	German
kistler	German
kistner	German
kleid	German
klein	German
klossner	German
knef	German
kneib	German
kneller	German
knepp	German
knochenmus	German
knopf	German
knopp	German
koch	German
kock	German
koenig	German
koenigsmann	German
kohl	German
kohler	German
kolbe	German
konig	German
konigsmann	German
kopp	German
kraemer	German
kramer	German
krantz	German
kranz	German
kraus	German
krause	German
krauss	German
krau	German
krebs	German
kroger	German
kron	German
kruckel	German
kruger	German
kruse	German
kuchler	German
kuhn	German
kundert	German
kunkel	German
kunkle	German
kuntz	German
kunze	German
kurzmann	German
laberenz	German
lafrentz	German
lafrenz	German
landau	German
lang	German
lange	German
langenberg	German
langer	German
larenz	German
laurenz	German
lauritz	German
lawerenz	German
lawrenz	German
lehmann	German
lehrer	German
leitner	German
leitz	German
leitzke	German
lenz	German
leverenz	German
lewerentz	German
lewerenz	German
lichtenberg	German
lieberenz	German
linden	German
loewe	German
lohrenz	German
lorentz	German
lorenz	German
lorenzen	German
loris	German
loritz	German
lowe	German
ludwig	German
luther	German
maas	German
maier	German
mandel	German
mann	German
markwardt	German
marquardt	German
marquering	German
marquerink	German
martell	German
martin	German
martz	German
mas	German
maurer	German
maus	German
mayer	German
meier	German
mein	German
meindl	German
meinhardt	German
meisner	German
meissner	German
melsbach	German
mendel	German
mendelsohn	German
mendelssohn	German
messer	German
messerli	German
messmann	German
messner	German
metz	German
metzger	German
meyer	German
michel	German
mohren	German
moller	German
morgenstern	German
moser	German
mueller	German
muhlfeld	German
muller	German
nagel	German
neuman	German
neumann	German
nuremberg	German
nussbaum	German
nussenbaum	German
oberst	German
oelberg	German
ohme	German
oliver	German
oppenheimer	German
ott	German
otto	German
oursler	German
pahlke	German
papke	German
papp	German
paternoster	German
paul	German
paulis	German
pawlitzki	German
penzig	German
peter	German
peters	German
pfaff	German
pfenning	German
plank	German
pletcher	German
porsche	German
portner	German
prinz	German
protz	German
rademacher	German
rademaker	German
rapp	German
raske	German
raskob	German
raskop	German
raskoph	German
regenbogen	German
reier	German
reiher	German
reiter	German
rettig	German
reuter	German
richard	German
richter	German
rier	German
riese	German
ritter	German
rose	German
rosenberg	German
rosenberger	German
rosenfeld	German
rot	German
roth	German
rothbauer	German
rothenberg	German
rothschild	German
sachs	German
saller	German
salomon	German
salzwedel	German
samuel	German
sander	German
sauber	German
schafer	German
scheer	German
scheinberg	German
schenck	German
schermer	German
schindler	German
schirmer	German
schlender	German
schlimme	German
schlusser	German
schmeling	German
schmid	German
schmidt	German
schmitt	German
schmitz	German
schneider	German
schnoor	German
schnur	German
schoettmer	German
schrader	German
schreck	German
schreier	German
schroder	German
schroeder	German
schroeter	German
schroter	German
schubert	German
schuchard	German
schuchardt	German
schuchert	German
schuhart	German
schuhmacher	German
schuler	German
schult	German
schulte	German
schultes	German
schultheis	German
schultheiss	German
schulthei	German
schultz	German
schultze	German
schulz	German
schulze	German
schumacher	German
schuster	German
schuttmann	German
schwangau	German
schwartz	German
schwarz	German
schwarzenegger	German
schwenke	German
schwinghammer	German
seelenfreund	German
seidel	German
senft	German
sheinfeld	German
shriver	German
siegel	German
siekert	German
siemon	German
silverstein	German
simen	German
simmon	German
simon	German
simons	German
siskin	German
siskind	German
sitz	German
slusser	German
solberg	German
sommer	German
sonnen	German
sorg	German
sorge	German
spannagel	German
specht	German
spellmeyer	German
spitznogle	German
sponaugle	German
stark	German
stauss	German
steen	German
steffen	German
stein	German
steinmann	German
stenger	German
sternberg	German
steube	German
steuben	German
stieber	German
stoppelbein	German
strand	German
straub	German
strobel	German
strohkirch	German
stroman	German
stuber	German
stueck	German
stumpf	German
sturm	German
suess	German
sulzbach	German
swango	German
switzer	German
tangeman	German
tanzer	German
teufel	German
tiedeman	German
tifft	German
tillens	German
tobias	German
tolkien	German
tresler	German
tritten	German
trumbauer	German
tschida	German
unkle	German
unruh	German
unterbrink	German
ursler	German
vann	German
van tonder	German
vieth	German
vogel	German
vogt	German
vogts	German
voigt	German
voigts	German
volk	German
voll	German
von brandt	German
von essen	German
von grimmelshausen	German
von ingersleben	German
vonnegut	German
von wegberg	German
voss	German
vo	German
wagner	German
wahner	German
waldfogel	German
waldvogel	German
walkenhorst	German
walter	German
walther	German
waltz	German
wang	German
warner	German
waxweiler	German
weber	German
wechsler	German
wedekind	German
weeber	German
wegener	German
wegner	German
wehner	German
wehunt	German
weigand	German
weiman	German
weiner	German
weiss	German
wei	German
welter	German
wendel	German
wendell	German
werner	German
wernher	German
west	German
westerberg	German
wetterman	German
wetzel	German
wexler	German
wieck	German
wiegand	German
wildgrube	German
winter	German
winther	German
wirner	German
wirnhier	German
wirt	German
wirth	German
wolf	German
wolff	German
wolter	German
worner	German
wornhor	German
wruck	German
wyman	German
xylander	German
zellweger	German
zilberschlag	German
zimmerman	German
zimmermann	German
abandonato	Italian
abatangelo	Italian
abatantuono	Italian
abate	Italian
abategiovanni	Italian
abatescianni	Italian
abba	Italian
abbadelli	Italian
abbascia	Italian
abbatangelo	Italian
abbatantuono	Italian
abbate	Italian
abbatelli	Italian
abbaticchio	Italian
abbiati	Italian
abbracciabene	Italian
abbracciabeni	Italian
abelli	Italian
abello	Italian
abrami	Italian
abramo	Italian
acardi	Italian
accardi	Italian
accardo	Italian
acciai	Italian
acciaio	Italian
acciaioli	Italian
acconci	Italian
acconcio	Italian
accorsi	Italian
accorso	Italian
accosi	Italian
accursio	Italian
acerbi	Italian
acone	Italian
aconi	Italian
acqua	Italian
acquafredda	Italian
acquarone	Italian
acquati	Italian
adalardi	Italian
adami	Italian
adamo	Italian
adamoli	Italian
addario	Italian
adelardi	Italian
adessi	Italian
adimari	Italian
adriatico	Italian
affini	Italian
africani	Italian
africano	Italian
agani	Italian
aggi	Italian
aggio	Italian
agli	Italian
agnelli	Italian
agnellutti	Italian
agnusdei	Italian
agosti	Italian
agostini	Italian
agresta	Italian
agrioli	Italian
aiello	Italian
aiolfi	Italian
airaldi	Italian
airo	Italian
aita	Italian
ajello	Italian
alagona	Italian
alamanni	Italian
albanesi	Italian
albani	Italian
albano	Italian
alberghi	Italian
alberghini	Italian
alberici	Italian
alberighi	Italian
albero	Italian
albini	Italian
albricci	Italian
albrici	Italian
alcheri	Italian
aldebrandi	Italian
alderisi	Italian
alduino	Italian
alemagna	Italian
aleppo	Italian
alesci	Italian
alescio	Italian
alesi	Italian
alesini	Italian
alesio	Italian
alessandri	Italian
alessi	Italian
alfero	Italian
aliberti	Italian
alinari	Italian
aliprandi	Italian
allegri	Italian
allegro	Italian
alo	Italian
aloia	Italian
aloisi	Italian
altamura	Italian
altimari	Italian
altoviti	Italian
alunni	Italian
amadei	Italian
amadori	Italian
amalberti	Italian
amantea	Italian
amato	Italian
amatore	Italian
ambrogi	Italian
ambrosi	Italian
amello	Italian
amerighi	Italian
amoretto	Italian
angioli	Italian
ansaldi	Italian
anselmetti	Italian
anselmi	Italian
antonelli	Italian
antonini	Italian
antonino	Italian
aquila	Italian
aquino	Italian
arbore	Italian
ardiccioni	Italian
ardizzone	Italian
ardovini	Italian
arena	Italian
aringheri	Italian
arlotti	Italian
armani	Italian
armati	Italian
armonni	Italian
arnolfi	Italian
arnoni	Italian
arrighetti	Italian
arrighi	Italian
arrigucci	Italian
aucciello	Italian
azzara	Italian
baggi	Italian
baggio	Italian
baglio	Italian
bagni	Italian
bagnoli	Italian
balboni	Italian
baldi	Italian
baldini	Italian
baldinotti	Italian
baldovini	Italian
bandini	Italian
bandoni	Italian
barbieri	Italian
barone	Italian
barsetti	Italian
bartalotti	Italian
bartolomei	Italian
bartolomeo	Italian
barzetti	Italian
basile	Italian
bassanelli	Italian
bassani	Italian
bassi	Italian
basso	Italian
basurto	Italian
battaglia	Italian
bazzoli	Italian
bellandi	Italian
bellandini	Italian
bellincioni	Italian
bellini	Italian
bello	Italian
bellomi	Italian
belloni	Italian
belluomi	Italian
belmonte	Italian
bencivenni	Italian
benedetti	Italian
benenati	Italian
benetton	Italian
benini	Italian
benivieni	Italian
benvenuti	Italian
berardi	Italian
bergamaschi	Italian
berti	Italian
bertolini	Italian
biancardi	Italian
bianchi	Italian
bicchieri	Italian
biondi	Italian
biondo	Italian
boerio	Italian
bologna	Italian
bondesan	Italian
bonomo	Italian
borghi	Italian
borgnino	Italian
borgogni	Italian
bosco	Italian
bove	Italian
bover	Italian
boveri	Italian
brambani	Italian
brambilla	Italian
breda	Italian
brioschi	Italian
brivio	Italian
brunetti	Italian
bruno	Italian
buffone	Italian
bulgarelli	Italian
bulgari	Italian
buonarroti	Italian
busto	Italian
caiazzo	Italian
caito	Italian
caivano	Italian
calabrese	Italian
calligaris	Italian
campana	Italian
campo	Italian
cantu	Italian
capello	Italian
capitani	Italian
carbone	Italian
carboni	Italian
carideo	Italian
carlevaro	Italian
caro	Italian
carracci	Italian
carrara	Italian
caruso	Italian
cassano	Italian
castro	Italian
catalano	Italian
cattaneo	Italian
cavalcante	Italian
cavallo	Italian
cingolani	Italian
cino	Italian
cipriani	Italian
cisternino	Italian
coiro	Italian
cola	Italian
colombera	Italian
colombo	Italian
columbo	Italian
como	Italian
confortola	Italian
conti	Italian
corna	Italian
corti	Italian
corvi	Italian
costa	Italian
costantini	Italian
costanzo	Italian
cracchiolo	Italian
cremaschi	Italian
cremona	Italian
cremonesi	Italian
crespo	Italian
croce	Italian
crocetti	Italian
cucinotta	Italian
cuocco	Italian
cuoco	Italian
d'ambrosio	Italian
damiani	Italian
d'amore	Italian
d'angelo	Italian
d'antonio	Italian
de angelis	Italian
de campo	Italian
de felice	Italian
de filippis	Italian
de fiore	Italian
de laurentis	Italian
de luca	Italian
de palma	Italian
de rege	Italian
de santis	Italian
de vitis	Italian
di antonio	Italian
di caprio	Italian
di mercurio	Italian
dinapoli	Italian
dioli	Italian
di pasqua	Italian
di pietro	Italian
di stefano	Italian
donati	Italian
d'onofrio	Italian
drago	Italian
durante	Italian
elena	Italian
episcopo	Italian
ermacora	Italian
esposito	Italian
evangelista	Italian
fabbri	Italian
fabbro	Italian
falco	Italian
faraldo	Italian
farina	Italian
farro	Italian
fattore	Italian
fausti	Italian
fava	Italian
favero	Italian
fermi	Italian
ferrara	Italian
ferrari	Italian
ferraro	Italian
ferrero	Italian
ferro	Italian
fierro	Italian
filippi	Italian
fini	Italian
fiore	Italian
fiscella	Italian
fonda	Italian
fontana	Italian
fortunato	Italian
franco	Italian
franzese	Italian
furlan	Italian
gabrielli	Italian
gagliardi	Italian
gallo	Italian
ganza	Italian
garfagnini	Italian
garofalo	Italian
gaspari	Italian
gatti	Italian
genovese	Italian
gentile	Italian
germano	Italian
giannino	Italian
gimondi	Italian
giordano	Italian
gismondi	Italian
giugovaz	Italian
giunta	Italian
goretti	Italian
gori	Italian
greco	Italian
grillo	Italian
grimaldi	Italian
gronchi	Italian
guarneri	Italian
guerra	Italian
guerriero	Italian
guidi	Italian
guttuso	Italian
idoni	Italian
innocenti	Italian
labriola	Italian
laconi	Italian
lagana	Italian
lagomarsino	Italian
lagorio	Italian
laguardia	Italian
lama	Italian
lamberti	Italian
lamon	Italian
landi	Italian
lando	Italian
landolfi	Italian
laterza	Italian
laurito	Italian
lazzari	Italian
lecce	Italian
leccese	Italian
leggieri	Italian
lemmi	Italian
leone	Italian
leoni	Italian
lippi	Italian
locatelli	Italian
lombardi	Italian
longo	Italian
lupo	Italian
luzzatto	Italian
maestri	Italian
magro	Italian
mancini	Italian
manco	Italian
mancuso	Italian
manfredi	Italian
manfredonia	Italian
mantovani	Italian
marchegiano	Italian
marchesi	Italian
marchetti	Italian
marchioni	Italian
marconi	Italian
mari	Italian
maria	Italian
mariani	Italian
marino	Italian
marmo	Italian
martelli	Italian
martinelli	Italian
masi	Italian
masin	Italian
mazza	Italian
merlo	Italian
messana	Italian
micheli	Italian
milani	Italian
milano	Italian
modugno	Italian
mondadori	Italian
mondo	Italian
montagna	Italian
montana	Italian
montanari	Italian
monte	Italian
monti	Italian
morandi	Italian
morello	Italian
moretti	Italian
morra	Italian
moschella	Italian
mosconi	Italian
motta	Italian
muggia	Italian
muraro	Italian
murgia	Italian
murtas	Italian
nacar	Italian
naggi	Italian
naggia	Italian
naldi	Italian
nana	Italian
nani	Italian
nanni	Italian
nannini	Italian
napoleoni	Italian
napoletani	Italian
napoliello	Italian
nardi	Italian
nardo	Italian
nardovino	Italian
nasato	Italian
nascimbene	Italian
nascimbeni	Italian
natale	Italian
nave	Italian
nazario	Italian
necchi	Italian
negri	Italian
negrini	Italian
nelli	Italian
nenci	Italian
nepi	Italian
neri	Italian
neroni	Italian
nervetti	Italian
nervi	Italian
nespola	Italian
nicastro	Italian
nicchi	Italian
nicodemo	Italian
nicolai	Italian
nicolosi	Italian
nicosia	Italian
nicotera	Italian
nieddu	Italian
nieri	Italian
nigro	Italian
nisi	Italian
nizzola	Italian
noschese	Italian
notaro	Italian
notoriano	Italian
oberti	Italian
oberto	Italian
ongaro	Italian
orlando	Italian
orsini	Italian
pace	Italian
padovan	Italian
padovano	Italian
pagani	Italian
pagano	Italian
palladino	Italian
palmisano	Italian
palumbo	Italian
panzavecchia	Italian
parisi	Italian
parma	Italian
parodi	Italian
parri	Italian
parrino	Italian
passerini	Italian
pastore	Italian
paternoster	Italian
pavesi	Italian
pavone	Italian
pavoni	Italian
pecora	Italian
pedrotti	Italian
pellegrino	Italian
perugia	Italian
pesaresi	Italian
pesaro	Italian
pesce	Italian
petri	Italian
pherigo	Italian
piazza	Italian
piccirillo	Italian
piccoli	Italian
pierno	Italian
pietri	Italian
pini	Italian
piovene	Italian
piraino	Italian
pisani	Italian
pittaluga	Italian
poggi	Italian
poggio	Italian
poletti	Italian
pontecorvo	Italian
portelli	Italian
porto	Italian
portoghese	Italian
potenza	Italian
pozzi	Italian
profeta	Italian
prosdocimi	Italian
provenza	Italian
provenzano	Italian
pugliese	Italian
quaranta	Italian
quattrocchi	Italian
ragno	Italian
raimondi	Italian
rais	Italian
rana	Italian
raneri	Italian
rao	Italian
rapallino	Italian
ratti	Italian
ravenna	Italian
re	Italian
ricchetti	Italian
ricci	Italian
riggi	Italian
righi	Italian
rinaldi	Italian
riva	Italian
rizzo	Italian
robustelli	Italian
rocca	Italian
rocchi	Italian
rocco	Italian
roma	Italian
romagna	Italian
romagnoli	Italian
romano	Italian
romero	Italian
roncalli	Italian
ronchi	Italian
rosa	Italian
rossi	Italian
rossini	Italian
rotolo	Italian
rovigatti	Italian
ruggeri	Italian
russo	Italian
rustici	Italian
ruzzier	Italian
sabbadin	Italian
sacco	Italian
sala	Italian
salomon	Italian
salucci	Italian
salvaggi	Italian
salvai	Italian
salvail	Italian
salvatici	Italian
salvay	Italian
sanna	Italian
sansone	Italian
santini	Italian
santoro	Italian
sapienti	Italian
sarno	Italian
sarti	Italian
sartini	Italian
sarto	Italian
savona	Italian
scarpa	Italian
scarsi	Italian
scavo	Italian
sciacca	Italian
sciacchitano	Italian
sciarra	Italian
scordato	Italian
scotti	Italian
scutese	Italian
sebastiani	Italian
sebastino	Italian
segreti	Italian
selmone	Italian
selvaggio	Italian
serafin	Italian
serafini	Italian
serpico	Italian
sessa	Italian
sgro	Italian
siena	Italian
silvestri	Italian
sinagra	Italian
soldati	Italian
somma	Italian
sordi	Italian
soriano	Italian
sorrentino	Italian
spada	Italian
spano	Italian
sparacello	Italian
speziale	Italian
spini	Italian
stabile	Italian
stablum	Italian
stilo	Italian
sultana	Italian
tafani	Italian
tamaro	Italian
tamboia	Italian
tanzi	Italian
tarantino	Italian
taverna	Italian
tedesco	Italian
terranova	Italian
terzi	Italian
tessaro	Italian
testa	Italian
tiraboschi	Italian
tivoli	Italian
todaro	Italian
toloni	Italian
tornincasa	Italian
toselli	Italian
tosetti	Italian
tosi	Italian
tosto	Italian
trapani	Italian
traversa	Italian
traversi	Italian
traversini	Italian
traverso	Italian
trucco	Italian
trudu	Italian
tumicelli	Italian
turati	Italian
turchi	Italian
uberti	Italian
uccello	Italian
uggeri	Italian
ughi	Italian
ungaretti	Italian
ungaro	Italian
vacca	Italian
vaccaro	Italian
valenti	Italian
valentini	Italian
valerio	Italian
varano	Italian
ventimiglia	Italian
ventura	Italian
verona	Italian
veronesi	Italian
vescovi	Italian
vespa	Italian
vestri	Italian
vicario	Italian
vico	Italian
vigo	Italian
villa	Italian
vinci	Italian
viola	Italian
vitali	Italian
viteri	Italian
voltolini	Italian
zambrano	Italian
zanetti	Italian
zangari	Italian
zappa	Italian
zeni	Italian
zini	Italian
zino	Italian
zunino	Italian
abe	Japanese
abukara	Japanese
adachi	Japanese
aida	Japanese
aihara	Japanese
aizawa	Japanese
ajibana	Japanese
akaike	Japanese
akamatsu	Japanese
akatsuka	Japanese
akechi	Japanese
akera	Japanese
akimoto	Japanese
akita	Japanese
akiyama	Japanese
akutagawa	Japanese
amagawa	Japanese
amaya	Japanese
amori	Japanese
anami	Japanese
ando	Japanese
anzai	Japanese
aoki	Japanese
arai	Japanese
arakawa	Japanese
araki	Japanese
arakida	Japanese
arato	Japanese
arihyoshi	Japanese
arishima	Japanese
arita	Japanese
ariwa	Japanese
ariwara	Japanese
asahara	Japanese
asahi	Japanese
asai	Japanese
asano	Japanese
asanuma	Japanese
asari	Japanese
ashia	Japanese
ashida	Japanese
ashikaga	Japanese
asuhara	Japanese
atshushi	Japanese
ayabito	Japanese
ayugai	Japanese
baba	Japanese
baisotei	Japanese
bando	Japanese
bunya	Japanese
chiba	Japanese
chikamatsu	Japanese
chikanatsu	Japanese
chino	Japanese
chishu	Japanese
choshi	Japanese
daishi	Japanese
dan	Japanese
date	Japanese
dazai	Japanese
deguchi	Japanese
deushi	Japanese
doi	Japanese
ebina	Japanese
ebisawa	Japanese
eda	Japanese
egami	Japanese
eguchi	Japanese
ekiguchi	Japanese
endo	Japanese
endoso	Japanese
enoki	Japanese
enomoto	Japanese
erizawa	Japanese
eto	Japanese
etsuko	Japanese
ezakiya	Japanese
fuchida	Japanese
fugunaga	Japanese
fujikage	Japanese
fujimaki	Japanese
fujimoto	Japanese
fujioka	Japanese
fujishima	Japanese
fujita	Japanese
fujiwara	Japanese
fukao	Japanese
fukayama	Japanese
fukuda	Japanese
fukumitsu	Japanese
fukunaka	Japanese
fukuoka	Japanese
fukusaku	Japanese
fukushima	Japanese
fukuyama	Japanese
fukuzawa	Japanese
fumihiko	Japanese
funabashi	Japanese
funaki	Japanese
funakoshi	Japanese
furusawa	Japanese
fuschida	Japanese
fuse	Japanese
futabatei	Japanese
fuwa	Japanese
gakusha	Japanese
genda	Japanese
genji	Japanese
gensai	Japanese
godo	Japanese
goto	Japanese
gushiken	Japanese
hachirobei	Japanese
haga	Japanese
hagino	Japanese
hagiwara	Japanese
hama	Japanese
hamacho	Japanese
hamada	Japanese
hamaguchi	Japanese
hamamoto	Japanese
hanabusa	Japanese
hanari	Japanese
handa	Japanese
hara	Japanese
harada	Japanese
haruguchi	Japanese
hasegawa	Japanese
hasekura	Japanese
hashimoto	Japanese
hasimoto	Japanese
hatakeda	Japanese
hatakeyama	Japanese
hatayama	Japanese
hatoyama	Japanese
hattori	Japanese
hayakawa	Japanese
hayami	Japanese
hayashi	Japanese
hayashida	Japanese
hayata	Japanese
hayuata	Japanese
hida	Japanese
hideaki	Japanese
hideki	Japanese
hideyoshi	Japanese
higashikuni	Japanese
higashiyama	Japanese
higo	Japanese
higoshi	Japanese
higuchi	Japanese
hike	Japanese
hino	Japanese
hira	Japanese
hiraga	Japanese
hiraki	Japanese
hirano	Japanese
hiranuma	Japanese
hiraoka	Japanese
hirase	Japanese
hirasi	Japanese
hirata	Japanese
hiratasuka	Japanese
hirayama	Japanese
hiro	Japanese
hirose	Japanese
hirota	Japanese
hiroyuki	Japanese
hisamatsu	Japanese
hishida	Japanese
hishikawa	Japanese
hitomi	Japanese
hiyama	Japanese
hohki	Japanese
hojo	Japanese
hokusai	Japanese
honami	Japanese
honda	Japanese
hori	Japanese
horigome	Japanese
horigoshi	Japanese
horiuchi	Japanese
horri	Japanese
hoshino	Japanese
hosokawa	Japanese
hosokaya	Japanese
hotate	Japanese
hotta	Japanese
hyata	Japanese
hyobanshi	Japanese
ibi	Japanese
ibu	Japanese
ibuka	Japanese
ichigawa	Japanese
ichihara	Japanese
ichikawa	Japanese
ichimonji	Japanese
ichiro	Japanese
ichisada	Japanese
ichiyusai	Japanese
idane	Japanese
iemochi	Japanese
ienari	Japanese
iesada	Japanese
ieyasu	Japanese
ieyoshi	Japanese
igarashi	Japanese
ihara	Japanese
ii	Japanese
iida	Japanese
iijima	Japanese
iitaka	Japanese
ijichi	Japanese
ijiri	Japanese
ikeda	Japanese
ikina	Japanese
ikoma	Japanese
imada	Japanese
imagawa	Japanese
imai	Japanese
imaizumi	Japanese
imamura	Japanese
imoo	Japanese
ina	Japanese
inaba	Japanese
inao	Japanese
inihara	Japanese
ino	Japanese
inoguchi	Japanese
inokuma	Japanese
inoue	Japanese
inouye	Japanese
inukai	Japanese
ippitsusai	Japanese
irie	Japanese
iriye	Japanese
isayama	Japanese
ise	Japanese
iseki	Japanese
iseya	Japanese
ishibashi	Japanese
ishida	Japanese
ishiguro	Japanese
ishihara	Japanese
ishikawa	Japanese
ishimaru	Japanese
ishimura	Japanese
ishinomori	Japanese
ishiyama	Japanese
isobe	Japanese
isoda	Japanese
isozaki	Japanese
itagaki	Japanese
itami	Japanese
ito	Japanese
itoh	Japanese
iwahara	Japanese
iwahashi	Japanese
iwakura	Japanese
iwasa	Japanese
iwasaki	Japanese
izumi	Japanese
jimbo	Japanese
jippensha	Japanese
jo	Japanese
joshuya	Japanese
joshuyo	Japanese
jukodo	Japanese
jumonji	Japanese
kada	Japanese
kagabu	Japanese
kagawa	Japanese
kahae	Japanese
kahaya	Japanese
kaibara	Japanese
kaima	Japanese
kajahara	Japanese
kajitani	Japanese
kajiwara	Japanese
kajiyama	Japanese
kakinomoto	Japanese
kakutama	Japanese
kamachi	Japanese
kamata	Japanese
kaminaga	Japanese
kamio	Japanese
kamioka	Japanese
kamisaka	Japanese
kamo	Japanese
kamon	Japanese
kan	Japanese
kanada	Japanese
kanagaki	Japanese
kanegawa	Japanese
kaneko	Japanese
kanesaka	Japanese
kano	Japanese
karamorita	Japanese
karube	Japanese
karubo	Japanese
kasahara	Japanese
kasai	Japanese
kasamatsu	Japanese
kasaya	Japanese
kase	Japanese
kashiwagi	Japanese
kasuse	Japanese
kataoka	Japanese
katayama	Japanese
katayanagi	Japanese
kate	Japanese
kato	Japanese
katoaka	Japanese
katsu	Japanese
katsukawa	Japanese
katsumata	Japanese
katsura	Japanese
katsushika	Japanese
kawabata	Japanese
kawachi	Japanese
kawagichi	Japanese
kawagishi	Japanese
kawaguchi	Japanese
kawai	Japanese
kawaii	Japanese
kawakami	Japanese
kawamata	Japanese
kawamura	Japanese
kawasaki	Japanese
kawasawa	Japanese
kawashima	Japanese
kawasie	Japanese
kawatake	Japanese
kawate	Japanese
kawayama	Japanese
kawazu	Japanese
kaza	Japanese
kazuyoshi	Japanese
kenkyusha	Japanese
kenmotsu	Japanese
kentaro	Japanese
ki	Japanese
kido	Japanese
kihara	Japanese
kijimuta	Japanese
kijmuta	Japanese
kikkawa	Japanese
kikuchi	Japanese
kikugawa	Japanese
kikui	Japanese
kikutake	Japanese
kimio	Japanese
kimiyama	Japanese
kimura	Japanese
kinashita	Japanese
kinoshita	Japanese
kinugasa	Japanese
kira	Japanese
kishi	Japanese
kiski	Japanese
kita	Japanese
kitabatake	Japanese
kitagawa	Japanese
kitamura	Japanese
kitano	Japanese
kitao	Japanese
kitoaji	Japanese
ko	Japanese
kobayashi	Japanese
kobi	Japanese
kodama	Japanese
koga	Japanese
kogara	Japanese
kogo	Japanese
koguchi	Japanese
koiso	Japanese
koizumi	Japanese
kojima	Japanese
kokan	Japanese
komagata	Japanese
komatsu	Japanese
komatsuzaki	Japanese
komine	Japanese
komiya	Japanese
komon	Japanese
komura	Japanese
kon	Japanese
konae	Japanese
konda	Japanese
kondo	Japanese
konishi	Japanese
kono	Japanese
konoe	Japanese
koruba	Japanese
koshin	Japanese
kotara	Japanese
kotoku	Japanese
koyama	Japanese
koyanagi	Japanese
kozu	Japanese
kubo	Japanese
kubota	Japanese
kudara	Japanese
kudo	Japanese
kuga	Japanese
kumagae	Japanese
kumasaka	Japanese
kunda	Japanese
kunikida	Japanese
kunisada	Japanese
kuno	Japanese
kunomasu	Japanese
kuramochi	Japanese
kuramoto	Japanese
kurata	Japanese
kurkawa	Japanese
kurmochi	Japanese
kuroda	Japanese
kurofuji	Japanese
kurogane	Japanese
kurohiko	Japanese
kuroki	Japanese
kurosawa	Japanese
kurusu	Japanese
kusatsu	Japanese
kusonoki	Japanese
kusuhara	Japanese
kusunoki	Japanese
kuwabara	Japanese
kwakami	Japanese
kyubei	Japanese
maeda	Japanese
maehata	Japanese
maeno	Japanese
maita	Japanese
makiguchi	Japanese
makino	Japanese
makioka	Japanese
makuda	Japanese
marubeni	Japanese
marugo	Japanese
marusa	Japanese
maruya	Japanese
maruyama	Japanese
masanobu	Japanese
masaoka	Japanese
mashita	Japanese
masoni	Japanese
masudu	Japanese
masuko	Japanese
masuno	Japanese
masuzoe	Japanese
matano	Japanese
matokai	Japanese
matoke	Japanese
matsuda	Japanese
matsukata	Japanese
matsuki	Japanese
matsumara	Japanese
matsumoto	Japanese
matsumura	Japanese
matsuo	Japanese
matsuoka	Japanese
matsura	Japanese
matsushina	Japanese
matsushita	Japanese
matsuya	Japanese
matsuzawa	Japanese
mayuzumi	Japanese
mazaki	Japanese
mazawa	Japanese
mazuka	Japanese
mifune	Japanese
mihashi	Japanese
miki	Japanese
mimasuya	Japanese
minabuchi	Japanese
minami	Japanese
minamoto	Japanese
minatoya	Japanese
minobe	Japanese
mishima	Japanese
mitsubishi	Japanese
mitsuharu	Japanese
mitsui	Japanese
mitsukuri	Japanese
mitsuwa	Japanese
mitsuya	Japanese
mitzusaka	Japanese
miura	Japanese
miwa	Japanese
miyagi	Japanese
miyahara	Japanese
miyajima	Japanese
miyake	Japanese
miyamae	Japanese
miyamoto	Japanese
miyazaki	Japanese
miyazawa	Japanese
miyoshi	Japanese
mizoguchi	Japanese
mizumaki	Japanese
mizuno	Japanese
mizutani	Japanese
modegi	Japanese
momotami	Japanese
momotani	Japanese
monomonoi	Japanese
mori	Japanese
moriguchi	Japanese
morimoto	Japanese
morinaga	Japanese
morioka	Japanese
morishita	Japanese
morisue	Japanese
morita	Japanese
morri	Japanese
moto	Japanese
motoori	Japanese
motoyoshi	Japanese
munakata	Japanese
munkata	Japanese
muraguchi	Japanese
murakami	Japanese
muraoka	Japanese
murasaki	Japanese
murase	Japanese
murata	Japanese
murkami	Japanese
muro	Japanese
muruyama	Japanese
mushanaokoji	Japanese
mushashibo	Japanese
muso	Japanese
mutsu	Japanese
nagahama	Japanese
nagai	Japanese
nagano	Japanese
nagasawa	Japanese
nagase	Japanese
nagata	Japanese
nagatsuka	Japanese
nagumo	Japanese
naito	Japanese
nakada	Japanese
nakadai	Japanese
nakadan	Japanese
nakae	Japanese
nakagawa	Japanese
nakahara	Japanese
nakajima	Japanese
nakamoto	Japanese
nakamura	Japanese
nakane	Japanese
nakanishi	Japanese
nakano	Japanese
nakanoi	Japanese
nakao	Japanese
nakasato	Japanese
nakasawa	Japanese
nakasone	Japanese
nakata	Japanese
nakatoni	Japanese
nakayama	Japanese
nakazawa	Japanese
namiki	Japanese
nanami	Japanese
narahashi	Japanese
narato	Japanese
narita	Japanese
nataga	Japanese
natsume	Japanese
nawabe	Japanese
nemoto	Japanese
niijima	Japanese
nijo	Japanese
ninomiya	Japanese
nishi	Japanese
nishihara	Japanese
nishikawa	Japanese
nishimoto	Japanese
nishimura	Japanese
nishimuraya	Japanese
nishio	Japanese
nishiwaki	Japanese
nitta	Japanese
nobunaga	Japanese
noda	Japanese
nogi	Japanese
noguchi	Japanese
nogushi	Japanese
nomura	Japanese
nonomura	Japanese
noro	Japanese
nosaka	Japanese
nose	Japanese
nozaki	Japanese
nozara	Japanese
numajiri	Japanese
numata	Japanese
obata	Japanese
obinata	Japanese
obuchi	Japanese
ochiai	Japanese
ochida	Japanese
odaka	Japanese
ogata	Japanese
ogiwara	Japanese
ogura	Japanese
ogyu	Japanese
ohba	Japanese
ohira	Japanese
ohishi	Japanese
ohka	Japanese
ohmae	Japanese
ohmiya	Japanese
oichi	Japanese
oinuma	Japanese
oishi	Japanese
okabe	Japanese
okada	Japanese
okakura	Japanese
okamoto	Japanese
okamura	Japanese
okanao	Japanese
okanaya	Japanese
okano	Japanese
okasawa	Japanese
okawa	Japanese
okazaki	Japanese
okazawaya	Japanese
okimasa	Japanese
okimoto	Japanese
okita	Japanese
okubo	Japanese
okuda	Japanese
okui	Japanese
okuma	Japanese
okumura	Japanese
okura	Japanese
omori	Japanese
omura	Japanese
onishi	Japanese
ono	Japanese
onoda	Japanese
onoe	Japanese
onohara	Japanese
ooka	Japanese
osagawa	Japanese
osaragi	Japanese
oshima	Japanese
oshin	Japanese
ota	Japanese
otaka	Japanese
otake	Japanese
otani	Japanese
otomo	Japanese
otsu	Japanese
otsuka	Japanese
ouchi	Japanese
oyama	Japanese
ozaki	Japanese
ozawa	Japanese
ozu	Japanese
raikatuji	Japanese
royama	Japanese
ryusaki	Japanese
sada	Japanese
saeki	Japanese
saga	Japanese
saigo	Japanese
saiki	Japanese
saionji	Japanese
saito	Japanese
saitoh	Japanese
saji	Japanese
sakagami	Japanese
sakai	Japanese
sakakibara	Japanese
sakamoto	Japanese
sakanoue	Japanese
sakata	Japanese
sakiyurai	Japanese
sakoda	Japanese
sakubara	Japanese
sakuraba	Japanese
sakurai	Japanese
sammiya	Japanese
sanda	Japanese
sanjo	Japanese
sano	Japanese
santo	Japanese
saromi	Japanese
sarumara	Japanese
sasada	Japanese
sasakawa	Japanese
sasaki	Japanese
sassa	Japanese
satake	Japanese
sato	Japanese
satoh	Japanese
satoya	Japanese
sawamatsu	Japanese
sawamura	Japanese
sayuki	Japanese
segawa	Japanese
sekigawa	Japanese
sekine	Japanese
sekozawa	Japanese
sen	Japanese
senmatsu	Japanese
seo	Japanese
serizawa	Japanese
shiba	Japanese
shibaguchi	Japanese
shibanuma	Japanese
shibasaki	Japanese
shibasawa	Japanese
shibata	Japanese
shibukji	Japanese
shichirobei	Japanese
shidehara	Japanese
shiga	Japanese
shiganori	Japanese
shige	Japanese
shigeki	Japanese
shigemitsu	Japanese
shigi	Japanese
shikitei	Japanese
shikuk	Japanese
shima	Japanese
shimada	Japanese
shimakage	Japanese
shimamura	Japanese
shimanouchi	Japanese
shimaoka	Japanese
shimazaki	Japanese
shimazu	Japanese
shimedzu	Japanese
shimizu	Japanese
shimohira	Japanese
shimon	Japanese
shimura	Japanese
shimuzu	Japanese
shinko	Japanese
shinozaki	Japanese
shinozuka	Japanese
shintaro	Japanese
shiokawa	Japanese
shiomi	Japanese
shiomiya	Japanese
shionoya	Japanese
shiotani	Japanese
shioya	Japanese
shirahata	Japanese
shirai	Japanese
shiraishi	Japanese
shirane	Japanese
shirasu	Japanese
shiratori	Japanese
shirokawa	Japanese
shiroyama	Japanese
shiskikura	Japanese
shizuma	Japanese
shobo	Japanese
shoda	Japanese
shunji	Japanese
shunsen	Japanese
siagyo	Japanese
soga	Japanese
sohda	Japanese
soho	Japanese
soma	Japanese
someya	Japanese
sone	Japanese
sonoda	Japanese
soseki	Japanese
sotomura	Japanese
suenami	Japanese
sugai	Japanese
sugase	Japanese
sugawara	Japanese
sugihara	Japanese
sugimura	Japanese
sugisata	Japanese
sugita	Japanese
sugitani	Japanese
sugiyama	Japanese
sumitimo	Japanese
sunada	Japanese
suzambo	Japanese
suzuki	Japanese
tabuchi	Japanese
tadeshi	Japanese
tagawa	Japanese
taguchi	Japanese
taira	Japanese
taka	Japanese
takabe	Japanese
takagaki	Japanese
takagawa	Japanese
takagi	Japanese
takahama	Japanese
takahashi	Japanese
takaki	Japanese
takamura	Japanese
takano	Japanese
takaoka	Japanese
takara	Japanese
takarabe	Japanese
takashi	Japanese
takashita	Japanese
takasu	Japanese
takasugi	Japanese
takayama	Japanese
takecare	Japanese
takeda	Japanese
takei	Japanese
takekawa	Japanese
takemago	Japanese
takemitsu	Japanese
takemura	Japanese
takenouchi	Japanese
takeshita	Japanese
taketomo	Japanese
takeuchi	Japanese
takewaki	Japanese
takimoto	Japanese
takishida	Japanese
takishita	Japanese
takizawa	Japanese
taku	Japanese
takudo	Japanese
takudome	Japanese
tamazaki	Japanese
tamura	Japanese
tamuro	Japanese
tanaka	Japanese
tange	Japanese
tani	Japanese
taniguchi	Japanese
tanizaki	Japanese
tankoshitsu	Japanese
tansho	Japanese
tanuma	Japanese
tarumi	Japanese
tatenaka	Japanese
tatsuko	Japanese
tatsuno	Japanese
tatsuya	Japanese
tawaraya	Japanese
tayama	Japanese
temko	Japanese
tenshin	Japanese
terada	Japanese
terajima	Japanese
terakado	Japanese
terauchi	Japanese
teshigahara	Japanese
teshima	Japanese
tochikura	Japanese
togo	Japanese
tojo	Japanese
tokaji	Japanese
tokuda	Japanese
tokudome	Japanese
tokuoka	Japanese
tomika	Japanese
tomimoto	Japanese
tomioka	Japanese
tommii	Japanese
tomonaga	Japanese
tomori	Japanese
tono	Japanese
torii	Japanese
torisei	Japanese
toru	Japanese
toshishai	Japanese
toshitala	Japanese
toshusai	Japanese
toyama	Japanese
toyoda	Japanese
toyoshima	Japanese
toyota	Japanese
toyotomi	Japanese
tsubouchi	Japanese
tsucgimoto	Japanese
tsuchie	Japanese
tsuda	Japanese
tsuji	Japanese
tsujimoto	Japanese
tsujimura	Japanese
tsukada	Japanese
tsukade	Japanese
tsukahara	Japanese
tsukamoto	Japanese
tsukatani	Japanese
tsukawaki	Japanese
tsukehara	Japanese
tsukioka	Japanese
tsumemasa	Japanese
tsumura	Japanese
tsunoda	Japanese
tsurimi	Japanese
tsuruga	Japanese
tsuruya	Japanese
tsushima	Japanese
tsutaya	Japanese
tsutomu	Japanese
uboshita	Japanese
uchida	Japanese
uchiyama	Japanese
ueda	Japanese
uehara	Japanese
uemura	Japanese
ueshima	Japanese
uesugi	Japanese
uetake	Japanese
ugaki	Japanese
ui	Japanese
ukiyo	Japanese
umari	Japanese
umehara	Japanese
umeki	Japanese
uno	Japanese
uoya	Japanese
urogataya	Japanese
usami	Japanese
ushiba	Japanese
utagawa	Japanese
wakai	Japanese
wakatsuki	Japanese
watabe	Japanese
watanabe	Japanese
watari	Japanese
watnabe	Japanese
watoga	Japanese
yakuta	Japanese
yamabe	Japanese
yamada	Japanese
yamagata	Japanese
yamaguchi	Japanese
yamaguchiya	Japanese
yamaha	Japanese
yamahata	Japanese
yamakage	Japanese
yamakawa	Japanese
yamakazi	Japanese
yamamoto	Japanese
yamamura	Japanese
yamana	Japanese
yamanaka	Japanese
yamanouchi	Japanese
yamanoue	Japanese
yamaoka	Japanese
yamashita	Japanese
yamato	Japanese
yamawaki	Japanese
yamazaki	Japanese
yamhata	Japanese
yamura	Japanese
yanagawa	Japanese
yanagi	Japanese
yanagimoto	Japanese
yanagita	Japanese
yano	Japanese
yasuda	Japanese
yasuhiro	Japanese
yasui	Japanese
yasujiro	Japanese
yasukawa	Japanese
yasutake	Japanese
yoemon	Japanese
yokokawa	Japanese
yokoyama	Japanese
yonai	Japanese
yosano	Japanese
yoshida	Japanese
yoshifumi	Japanese
yoshihara	Japanese
yoshikawa	Japanese
yoshimatsu	Japanese
yoshinobu	Japanese
yoshioka	Japanese
yoshitomi	Japanese
yoshizaki	Japanese
yoshizawa	Japanese
yuasa	Japanese
yuhara	Japanese
yunokawa	Japanese
abel	French
abraham	French
adam	French
albert	French
allard	French
archambault	French
armistead	French
arthur	French
augustin	French
babineaux	French
baudin	French
beauchene	French
beaulieu	French
beaumont	French
belanger	French
bellamy	French
bellerose	French
belrose	French
berger	French
beringer	French
bernard	French
bertrand	French
bisset	French
bissette	French
blaise	French
blanc	French
blanchet	French
blanchett	French
bonfils	French
bonheur	French
bonhomme	French
bonnaire	French
bonnay	French
bonner	French
bonnet	French
borde	French
bordelon	French
bouchard	French
boucher	French
brisbois	French
brodeur	French
bureau	French
caron	French
cavey	French
chaput	French
charbonneau	French
charpentier	French
charron	French
chastain	French
chevalier	French
chevrolet	French
cloutier	French
colbert	French
comtois	French
cornett	French
cote	French
coupe	French
courtemanche	French
cousineau	French
couture	French
daniau	French
d'aramitz	French
daviau	French
david	French
deforest	French
degarmo	French
delacroix	French
de la fontaine	French
deniau	French
deniaud	French
deniel	French
denis	French
de sauveterre	French
deschamps	French
descoteaux	French
desjardins	French
desrochers	French
desrosiers	French
dubois	French
duchamps	French
dufort	French
dufour	French
duguay	French
dupond	French
dupont	French
durand	French
durant	French
duval	French
emile	French
eustis	French
fabian	French
fabre	French
fabron	French
faucher	French
faucheux	French
faure	French
favager	French
favre	French
favreau	French
fay	French
felix	French
firmin	French
fontaine	French
forest	French
forestier	French
fortier	French
foss	French
fournier	French
gage	French
gagne	French
gagnier	French
gagnon	French
garcon	French
gardinier	French
germain	French
geroux	French
giles	French
girard	French
giroux	French
glaisyer	French
gosse	French
gosselin	French
granger	French
guerin	French
guillory	French
hardy	French
harman	French
hebert	French
herbert	French
herriot	French
jacques	French
janvier	French
jordan	French
joubert	French
labelle	French
lachance	French
lachapelle	French
lamar	French
lambert	French
lane	French
langlais	French
langlois	French
lapointe	French
larue	French
laurent	French
lavigne	French
lavoie	French
leandres	French
lebeau	French
leblanc	French
leclair	French
leclerc	French
lecuyer	French
lefebvre	French
lefevre	French
lefurgey	French
legrand	French
lemaire	French
lemieux	French
leon	French
leroy	French
lesauvage	French
lestrange	French
leveque	French
levesque	French
linville	French
lyon	French
macon	French
marchand	French
marie	French
marion	French
martel	French
martin	French
masson	French
mathieu	French
mercier	French
merle	French
michaud	French
michel	French
monet	French
monette	French
montagne	French
moreau	French
moulin	French
mullins	French
noel	French
oliver	French
olivier	French
page	French
paget	French
palomer	French
pan	French
pape	French
paquet	French
parent	French
paris	French
parris	French
pascal	French
patenaude	French
paternoster	French
paul	French
pelletier	French
perrault	French
perreault	French
perrot	French
petit	French
pettigrew	French
pierre	French
plamondon	French
plourde	French
poingdestre	French
poirier	French
porcher	French
poulin	French
proulx	French
renaud	French
rey	French
reyer	French
richard	French
richelieu	French
robert	French
roche	French
rome	French
romilly	French
rose	French
rousseau	French
roux	French
roy	French
royer	French
salomon	French
salvage	French
samson	French
samuel	French
sargent	French
sarkozi	French
sarkozy	French
sartre	French
sault	French
sauvage	French
sauvageau	French
sauvageon	French
sauvageot	French
sauveterre	French
savatier	French
segal	French
sergeant	French
severin	French
simon	French
solomon	French
soucy	French
st martin	French
st pierre	French
tailler	French
tasse	French
thayer	French
thibault	French
thomas	French
tobias	French
tolbert	French
traver	French
travere	French
travers	French
traverse	French
travert	French
tremblay	French
tremble	French
victor	French
victors	French
villeneuve	French
vincent	French
vipond	French
voclain	French
yount	French
achilles	German
achterberg	German
acker	German
ackermann	German
adam	German
adenauer	German
adler	German
adlersflugel	German
aeschelman	German
albert	German
albrecht	German
aleshire	German
aleshite	German
althaus	German
amsel	German
andres	German
armbruster	German
artz	German
aue	German
auer	German
augustin	German
aust	German
autenburg	German
auttenberg	German
baasch	German
bach	German
bachmeier	German
backer	German
bader	German
bahr	German
bambach	German
bauer	German
bauers	German
baum	German
baumann	German
baumbach	German
baumgartner	German
baumhauer	German
bayer	German
beck	German
becke	German
beckenbauer	German
becker	German
beckert	German
behrend	German
behrends	German
beitel	German
beltz	German
benn	German
berg	German
berger	German
bergfalk	German
beringer	German
bernat	German
best	German
beutel	German
beyer	German
beyersdorf	German
bieber	German
biermann	German
bischoffs	German
blau	German
blecher	German
bleier	German
blumenthal	German
blumstein	German
bocker	German
boehler	German
boer	German
boesch	German
bohler	German
bohm	German
bohme	German
bohmer	German
bohn	German
borchard	German
bosch	German
bottcher	German
brahms	German
brand	German
brandt	German
brant	German
brauer	German
braun	German
braune	German
breiner	German
breisacher	German
breitbarth	German
bretz	German
brinkerhoff	German
brodbeck	German
brose	German
brotz	German
bruhn	German
brun	German
brune	German
buchholz	German
buckholtz	German
buhr	German
bumgarner	German
burgstaller	German
busch	German
carver	German
chevrolet	German
cline	German
dahl	German
denzel	German
derrick	German
diefenbach	German
dieter	German
dietrich	German
dirchs	German
dittmar	German
dohman	German
drechsler	German
dreher	German
dreschner	German
dresdner	German
dressler	German
duerr	German
dunkle	German
dunst	German
durr	German
eberhardt	German
ebner	German
eckstein	German
egger	German
eichel	German
eilerts	German
engel	German
enns	German
esser	German
essert	German
everhart	German
fabel	German
faerber	German
falk	German
falkenrath	German
farber	German
fashingbauer	German
faust	German
feigenbaum	German
feld	German
feldt	German
fenstermacher	German
fertig	German
fiedler	German
fischer	German
flater	German
fleischer	German
foerstner	German
forst	German
forstner	German
foth	German
frank	German
franke	German
frei	German
freud	German
freudenberger	German
freund	German
fried	German
friedrich	German
fromm	German
frost	German
fuchs	German
fuhrmann	German
furst	German
fux	German
gabler	German
gaertner	German
garb	German
garber	German
gartner	German
garver	German
gass	German
gehrig	German
gehring	German
geier	German
geiger	German
geisler	German
geissler	German
geiszler	German
gensch	German
gerber	German
gerhard	German
gerhardt	German
gerig	German
gerst	German
gerstle	German
gerver	German
giehl	German
giese	German
glockner	German
goebel	German
goldschmidt	German
gorman	German
gott	German
gotti	German
gottlieb	German
gottschalk	German
graner	German
greenberg	German
groos	German
gros	German
gross	German
gro	German
groe	German
grosse	German
groel	German
groer	German
grosser	German
grosz	German
grunewald	German
gunther	German
gutermuth	German
gwerder	German
haas	German
haase	German
haber	German
habich	German
habicht	German
hafner	German
hahn	German
hall	German
halle	German
harman	German
hartmann	German
hase	German
hasek	German
hasenkamp	German
hass	German
hauer	German
haupt	German
hausler	German
havener	German
heidrich	German
heinrich	German
heinrichs	German
heintze	German
hellewege	German
heppenheimer	German
herbert	German
hermann	German
herrmann	German
herschel	German
hertz	German
hildebrand	German
hinrichs	German
hintzen	German
hirsch	German
hoch	German
hochberg	German
hoefler	German
hofer	German
hoffman	German
hoffmann	German
hofler	German
hofmann	German
hofmeister	German
holst	German
holtzer	German
holzer	German
holzknecht	German
holzmann	German
hoover	German
horn	German
horowitz	German
houk	German
huber	German
huff	German
huffman	German
huffmann	German
hummel	German
hutmacher	German
ingersleben	German
jaeger	German
jager	German
jans	German
janson	German
janz	German
jollenbeck	German
jordan	German
jund	German
jung	German
junge	German
kahler	German
kaiser	German
kalb	German
kalbfleisch	German
kappel	German
karl	German
kaspar	German
kassmeyer	German
kastner	German
katz	German
kaube	German
kaufer	German
kauffmann	German
kaufman	German
keil	German
keller	German
kempf	German
kerner	German
kerper	German
kerwar	German
kerwer	German
kiefer	German
kirchner	German
kistler	German
kistner	German
kleid	German
klein	German
klossner	German
knef	German
kneib	German
kneller	German
knepp	German
knochenmus	German
knopf	German
knopp	German
koch	German
kock	German
koenig	German
koenigsmann	German
kohl	German
kohler	German
kolbe	German
konig	German
konigsmann	German
kopp	German
kraemer	German
kramer	German
krantz	German
kranz	German
kraus	German
krause	German
krauss	German
krau	German
krebs	German
kroger	German
kron	German
kruckel	German
kruger	German
kruse	German
kuchler	German
kuhn	German
kundert	German
kunkel	German
kunkle	German
kuntz	German
kunze	German
kurzmann	German
laberenz	German
lafrentz	German
lafrenz	German
landau	German
lang	German
lange	German
langenberg	German
langer	German
larenz	German
laurenz	German
lauritz	German
lawerenz	German
lawrenz	German
lehmann	German
lehrer	German
leitner	German
leitz	German
leitzke	German
lenz	German
leverenz	German
lewerentz	German
lewerenz	German
lichtenberg	German
lieberenz	German
linden	German
loewe	German
lohrenz	German
lorentz	German
lorenz	German
lorenzen	German
loris	German
loritz	German
lowe	German
ludwig	German
luther	German
maas	German
maier	German
mandel	German
mann	German
markwardt	German
marquardt	German
marquering	German
marquerink	German
martell	German
martin	German
martz	German
mas	German
maurer	German
maus	German
mayer	German
meier	German
mein	German
meindl	German
meinhardt	German
meisner	German
meissner	German
melsbach	German
mendel	German
mendelsohn	German
mendelssohn	German
messer	German
messerli	German
messmann	German
messner	German
metz	German
metzger	German
meyer	German
michel	German
mohren	German
moller	German
morgenstern	German
moser	German
mueller	German
muhlfeld	German
muller	German
nagel	German
neuman	German
neumann	German
nuremberg	German
nussbaum	German
nussenbaum	German
oberst	German
oelberg	German
ohme	German
oliver	German
oppenheimer	German
ott	German
otto	German
oursler	German
pahlke	German
papke	German
papp	German
paternoster	German
paul	German
paulis	German
pawlitzki	German
penzig	German
peter	German
peters	German
pfaff	German
pfenning	German
plank	German
pletcher	German
porsche	German
portner	German
prinz	German
protz	German
rademacher	German
rademaker	German
rapp	German
raske	German
raskob	German
raskop	German
raskoph	German
regenbogen	German
reier	German
reiher	German
reiter	German
rettig	German
reuter	German
richard	German
richter	German
rier	German
riese	German
ritter	German
rose	German
rosenberg	German
rosenberger	German
rosenfeld	German
rot	German
roth	German
rothbauer	German
rothenberg	German
rothschild	German
sachs	German
saller	German
salomon	German
salzwedel	German
samuel	German
sander	German
sauber	German
schafer	German
scheer	German
scheinberg	German
schenck	German
schermer	German
schindler	German
schirmer	German
schlender	German
schlimme	German
schlusser	German
schmeling	German
schmid	German
schmidt	German
schmitt	German
schmitz	German
schneider	German
schnoor	German
schnur	German
schoettmer	German
schrader	German
schreck	German
schreier	German
schroder	German
schroeder	German
schroeter	German
schroter	German
schubert	German
schuchard	German
schuchardt	German
schuchert	German
schuhart	German
schuhmacher	German
schuler	German
schult	German
schulte	German
schultes	German
schultheis	German
schultheiss	German
schulthei	German
schultz	German
schultze	German
schulz	German
schulze	German
schumacher	German
schuster	German
schuttmann	German
schwangau	German
schwartz	German
schwarz	German
schwarzenegger	German
schwenke	German
schwinghammer	German
seelenfreund	German
seidel	German
senft	German
sheinfeld	German
shriver	German
siegel	German
siekert	German
siemon	German
silverstein	German
simen	German
simmon	German
simon	German
simons	German
siskin	German
siskind	German
sitz	German
slusser	German
solberg	German
sommer	German
sonnen	German
sorg	German
sorge	German
spannagel	German
specht	German
spellmeyer	German
spitznogle	German
sponaugle	German
stark	German
stauss	German
steen	German
steffen	German
stein	German
steinmann	German
stenger	German
sternberg	German
steube	German
steuben	German
stieber	German
stoppelbein	German
strand	German
straub	German
strobel	German
strohkirch	German
stroman	German
stuber	German
stueck	German
stumpf	German
sturm	German
suess	German
sulzbach	German
swango	German
switzer	German
tangeman	German
tanzer	German
teufel	German
tiedeman	German
tifft	German
tillens	German
tobias	German
tolkien	German
tresler	German
tritten	German
trumbauer	German
tschida	German
unkle	German
unruh	German
unterbrink	German
ursler	German
vann	German
van tonder	German
vieth	German
vogel	German
vogt	German
vogts	German
voigt	German
voigts	German
volk	German
voll	German
von brandt	German
von essen	German
von grimmelshausen	German
von ingersleben	German
vonnegut	German
von wegberg	German
voss	German
vo	German
wagner	German
wahner	German
waldfogel	German
waldvogel	German
walkenhorst	German
walter	German
walther	German
waltz	German
wang	German
warner	German
waxweiler	German
weber	German
wechsler	German
wedekind	German
weeber	German
wegener	German
wegner	German
wehner	German
wehunt	German
weigand	German
weiman	German
weiner	German
weiss	German
wei	German
welter	German
wendel	German
wendell	German
werner	German
wernher	German
west	German
westerberg	German
wetterman	German
wetzel	German
wexler	German
wieck	German
wiegand	German
wildgrube	German
winter	German
winther	German
wirner	German
wirnhier	German
wirt	German
wirth	German
wolf	German
wolff	German
wolter	German
worner	German
wornhor	German
wruck	German
wyman	German
xylander	German
zellweger	German
zilberschlag	German
zimmerman	German
zimmermann	German
abel	French
abraham	French
adam	French
albert	French
allard	French
archambault	French
armistead	French
arthur	French
augustin	French
babineaux	French
baudin	French
beauchene	French
beaulieu	French
beaumont	French
belanger	French
bellamy	French
bellerose	French
belrose	French
berger	French
beringer	French
bernard	French
bertrand	French
bisset	French
bissette	French
blaise	French
blanc	French
blanchet	French
blanchett	French
bonfils	French
bonheur	French
bonhomme	French
bonnaire	French
bonnay	French
bonner	French
bonnet	French
borde	French
bordelon	French
bouchard	French
boucher	French
brisbois	French
brodeur	French
bureau	French
caron	French
cavey	French
chaput	French
charbonneau	French
charpentier	French
charron	French
chastain	French
chevalier	French
chevrolet	French
cloutier	French
colbert	French
comtois	French
cornett	French
cote	French
coupe	French
courtemanche	French
cousineau	French
couture	French
daniau	French
d'aramitz	French
daviau	French
david	French
deforest	French
degarmo	French
delacroix	French
de la fontaine	French
deniau	French
deniaud	French
deniel	French
denis	French
de sauveterre	French
deschamps	French
descoteaux	French
desjardins	French
desrochers	French
desrosiers	French
dubois	French
duchamps	French
dufort	French
dufour	French
duguay	French
dupond	French
dupont	French
durand	French
durant	French
duval	French
emile	French
eustis	French
fabian	French
fabre	French
fabron	French
faucher	French
faucheux	French
faure	French
favager	French
favre	French
favreau	French
fay	French
felix	French
firmin	French
fontaine	French
forest	French
forestier	French
fortier	French
foss	French
fournier	French
gage	French
gagne	French
gagnier	French
gagnon	French
garcon	French
gardinier	French
germain	French
geroux	French
giles	French
girard	French
giroux	French
glaisyer	French
gosse	French
gosselin	French
granger	French
guerin	French
guillory	French
hardy	French
harman	French
hebert	French
herbert	French
herriot	French
jacques	French
janvier	French
jordan	French
joubert	French
labelle	French
lachance	French
lachapelle	French
lamar	French
lambert	French
lane	French
langlais	French
langlois	French
lapointe	French
larue	French
laurent	French
lavigne	French
lavoie	French
leandres	French
lebeau	French
leblanc	French
leclair	French
leclerc	French
lecuyer	French
lefebvre	French
lefevre	French
lefurgey	French
legrand	French
lemaire	French
lemieux	French
leon	French
leroy	French
lesauvage	French
lestrange	French
leveque	French
levesque	French
linville	French
lyon	French
macon	French
marchand	French
marie	French
marion	French
martel	French
martin	French
masson	French
mathieu	French
mercier	French
merle	French
michaud	French
michel	French
monet	French
monette	French
montagne	French
moreau	French
moulin	French
mullins	French
noel	French
oliver	French
olivier	French
page	French
paget	French
palomer	French
pan	French
pape	French
paquet	French
parent	French
paris	French
parris	French
pascal	French
patenaude	French
paternoster	French
paul	French
pelletier	French
perrault	French
perreault	French
perrot	French
petit	French
pettigrew	French
pierre	French
plamondon	French
plourde	French
poingdestre	French
poirier	French
porcher	French
poulin	French
proulx	French
renaud	French
rey	French
reyer	French
richard	French
richelieu	French
robert	French
roche	French
rome	French
romilly	French
rose	French
rousseau	French
roux	French
roy	French
royer	French
salomon	French
salvage	French
samson	French
samuel	French
sargent	French
sarkozi	French
sarkozy	French
sartre	French
sault	French
sauvage	French
sauvageau	French
sauvageon	French
sauvageot	French
sauveterre	French
savatier	French
segal	French
sergeant	French
severin	French
simon	French
solomon	French
soucy	French
st martin	French
st pierre	French
tailler	French
tasse	French
thayer	French
thibault	French
thomas	French
tobias	French
tolbert	French
traver	French
travere	French
travers	French
traverse	French
travert	French
tremblay	French
tremble	French
victor	French
victors	French
villeneuve	French
vincent	French
vipond	French
voclain	French
yount	French
achilles	German
achterberg	German
acker	German
ackermann	German
adam	German
adenauer	German
adler	German
adlersflugel	German
aeschelman	German
albert	German
albrecht	German
aleshire	German
aleshite	German
althaus	German
amsel	German
andres	German
armbruster	German
artz	German
aue	German
auer	German
augustin	German
aust	German
autenburg	German
auttenberg	German
baasch	German
bach	German
bachmeier	German
backer	German
bader	German
bahr	German
bambach	German
bauer	German
bauers	German
baum	German
baumann	German
baumbach	German
baumgartner	German
baumhauer	German
bayer	German
beck	German
becke	German
beckenbauer	German
becker	German
beckert	German
behrend	German
behrends	German
beitel	German
beltz	German
benn	German
berg	German
berger	German
bergfalk	German
beringer	German
bernat	German
best	German
beutel	German
beyer	German
beyersdorf	German
bieber	German
biermann	German
bischoffs	German
blau	German
blecher	German
bleier	German
blumenthal	German
blumstein	German
bocker	German
boehler	German
boer	German
boesch	German
bohler	German
bohm	German
bohme	German
bohmer	German
bohn	German
borchard	German
bosch	German
bottcher	German
brahms	German
brand	German
brandt	German
brant	German
brauer	German
braun	German
braune	German
breiner	German
breisacher	German
breitbarth	German
bretz	German
brinkerhoff	German
brodbeck	German
brose	German
brotz	German
bruhn	German
brun	German
brune	German
buchholz	German
buckholtz	German
buhr	German
bumgarner	German
burgstaller	German
busch	German
carver	German
chevrolet	German
cline	German
dahl	German
denzel	German
derrick	German
diefenbach	German
dieter	German
dietrich	German
dirchs	German
dittmar	German
dohman	German
drechsler	German
dreher	German
dreschner	German
dresdner	German
dressler	German
duerr	German
dunkle	German
dunst	German
durr	German
eberhardt	German
ebner	German
eckstein	German
egger	German
eichel	German
eilerts	German
engel	German
enns	German
esser	German
essert	German
everhart	German
fabel	German
faerber	German
falk	German
falkenrath	German
farber	German
fashingbauer	German
faust	German
feigenbaum	German
feld	German
feldt	German
fenstermacher	German
fertig	German
fiedler	German
fischer	German
flater	German
fleischer	German
foerstner	German
forst	German
forstner	German
foth	German
frank	German
franke	German
frei	German
freud	German
freudenberger	German
freund	German
fried	German
friedrich	German
fromm	German
frost	German
fuchs	German
fuhrmann	German
furst	German
fux	German
gabler	German
gaertner	German
garb	German
garber	German
gartner	German
garver	German
gass	German
gehrig	German
gehring	German
geier	German
geiger	German
geisler	German
geissler	German
geiszler	German
gensch	German
gerber	German
gerhard	German
gerhardt	German
gerig	German
gerst	German
gerstle	German
gerver	German
giehl	German
giese	German
glockner	German
goebel	German
goldschmidt	German
gorman	German
gott	German
gotti	German
gottlieb	German
gottschalk	German
graner	German
greenberg	German
groos	German
gros	German
gross	German
gro	German
groe	German
grosse	German
groel	German
groer	German
grosser	German
grosz	German
grunewald	German
gunther	German
gutermuth	German
gwerder	German
haas	German
haase	German
haber	German
habich	German
habicht	German
hafner	German
hahn	German
hall	German
halle	German
harman	German
hartmann	German
hase	German
hasek	German
hasenkamp	German
hass	German
hauer	German
haupt	German
hausler	German
havener	German
heidrich	German
heinrich	German
heinrichs	German
heintze	German
hellewege	German
heppenheimer	German
herbert	German
hermann	German
herrmann	German
herschel	German
hertz	German
hildebrand	German
hinrichs	German
hintzen	German
hirsch	German
hoch	German
hochberg	German
hoefler	German
hofer	German
hoffman	German
hoffmann	German
hofler	German
hofmann	German
hofmeister	German
holst	German
holtzer	German
holzer	German
holzknecht	German
holzmann	German
hoover	German
horn	German
horowitz	German
houk	German
huber	German
huff	German
huffman	German
huffmann	German
hummel	German
hutmacher	German
ingersleben	German
jaeger	German
jager	German
jans	German
janson	German
janz	German
jollenbeck	German
jordan	German
jund	German
jung	German
junge	German
kahler	German
kaiser	German
kalb	German
kalbfleisch	German
kappel	German
karl	German
kaspar	German
kassmeyer	German
kastner	German
katz	German
kaube	German
kaufer	German
kauffmann	German
kaufman	German
keil	German
keller	German
kempf	German
kerner	German
kerper	German
kerwar	German
kerwer	German
kiefer	German
kirchner	German
kistler	German
kistner	German
kleid	German
klein	German
klossner	German
knef	German
kneib	German
kneller	German
knepp	German
knochenmus	German
knopf	German
knopp	German
koch	German
kock	German
koenig	German
koenigsmann	German
kohl	German
kohler	German
kolbe	German
konig	German
konigsmann	German
kopp	German
kraemer	German
kramer	German
krantz	German
kranz	German
kraus	German
krause	German
krauss	German
krau	German
krebs	German
kroger	German
kron	German
kruckel	German
kruger	German
kruse	German
kuchler	German
kuhn	German
kundert	German
kunkel	German
kunkle	German
kuntz	German
kunze	German
kurzmann	German
laberenz	German
lafrentz	German
lafrenz	German
landau	German
lang	German
lange	German
langenberg	German
langer	German
larenz	German
laurenz	German
lauritz	German
lawerenz	German
lawrenz	German
lehmann	German
lehrer	German
leitner	German
leitz	German
leitzke	German
lenz	German
leverenz	German
lewerentz	German
lewerenz	German
lichtenberg	German
lieberenz	German
linden	German
loewe	German
lohrenz	German
lorentz	German
lorenz	German
lorenzen	German
loris	German
loritz	German
lowe	German
ludwig	German
luther	German
maas	German
maier	German
mandel	German
mann	German
markwardt	German
marquardt	German
marquering	German
marquerink	German
martell	German
martin	German
martz	German
mas	German
maurer	German
maus	German
mayer	German
meier	German
mein	German
meindl	German
meinhardt	German
meisner	German
meissner	German
melsbach	German
mendel	German
mendelsohn	German
mendelssohn	German
messer	German
messerli	German
messmann	German
messner	German
metz	German
metzger	German
meyer	German
michel	German
mohren	German
moller	German
morgenstern	German
moser	German
mueller	German
muhlfeld	German
muller	German
nagel	German
neuman	German
neumann	German
nuremberg	German
nussbaum	German
nussenbaum	German
oberst	German
oelberg	German
ohme	German
oliver	German
oppenheimer	German
ott	German
otto	German
oursler	German
pahlke	German
papke	German
papp	German
paternoster	German
paul	German
paulis	German
pawlitzki	German
penzig	German
peter	German
peters	German
pfaff	German
pfenning	German
plank	German
pletcher	German
porsche	German
portner	German
prinz	German
protz	German
rademacher	German
rademaker	German
rapp	German
raske	German
raskob	German
raskop	German
raskoph	German
regenbogen	German
reier	German
reiher	German
reiter	German
rettig	German
reuter	German
richard	German
richter	German
rier	German
riese	German
ritter	German
rose	German
rosenberg	German
rosenberger	German
rosenfeld	German
rot	German
roth	German
rothbauer	German
rothenberg	German
rothschild	German
sachs	German
saller	German
salomon	German
salzwedel	German
samuel	German
sander	German
sauber	German
schafer	German
scheer	German
scheinberg	German
schenck	German
schermer	German
schindler	German
schirmer	German
schlender	German
schlimme	German
schlusser	German
schmeling	German
schmid	German
schmidt	German
schmitt	German
schmitz	German
schneider	German
schnoor	German
schnur	German
schoettmer	German
schrader	German
schreck	German
schreier	German
schroder	German
schroeder	German
schroeter	German
schroter	German
schubert	German
schuchard	German
schuchardt	German
schuchert	German
schuhart	German
schuhmacher	German
schuler	German
schult	German
schulte	German
schultes	German
schultheis	German
schultheiss	German
schulthei	German
schultz	German
schultze	German
schulz	German
schulze	German
schumacher	German
schuster	German
schuttmann	German
schwangau	German
schwartz	German
schwarz	German
schwarzenegger	German
schwenke	German
schwinghammer	German
seelenfreund	German
seidel	German
senft	German
sheinfeld	German
shriver	German
siegel	German
siekert	German
siemon	German
silverstein	German
simen	German
simmon	German
simon	German
simons	German
siskin	German
siskind	German
sitz	German
slusser	German
solberg	German
sommer	German
sonnen	German
sorg	German
sorge	German
spannagel	German
specht	German
spellmeyer	German
spitznogle	German
sponaugle	German
stark	German
stauss	German
steen	German
steffen	German
stein	German
steinmann	German
stenger	German
sternberg	German
steube	German
steuben	German
stieber	German
stoppelbein	German
strand	German
straub	German
strobel	German
strohkirch	German
stroman	German
stuber	German
stueck	German
stumpf	German
sturm	German
suess	German
sulzbach	German
swango	German
switzer	German
tangeman	German
tanzer	German
teufel	German
tiedeman	German
tifft	German
tillens	German
tobias	German
tolkien	German
tresler	German
tritten	German
trumbauer	German
tschida	German
unkle	German
unruh	German
unterbrink	German
ursler	German
vann	German
van tonder	German
vieth	German
vogel	German
vogt	German
vogts	German
voigt	German
voigts	German
volk	German
voll	German
von brandt	German
von essen	German
von grimmelshausen	German
von ingersleben	German
vonnegut	German
von wegberg	German
voss	German
vo	German
wagner	German
wahner	German
waldfogel	German
waldvogel	German
walkenhorst	German
walter	German
walther	German
waltz	German
wang	German
warner	German
waxweiler	German
weber	German
wechsler	German
wedekind	German
weeber	German
wegener	German
wegner	German
wehner	German
wehunt	German
weigand	German
weiman	German
weiner	German
weiss	German
wei	German
welter	German
wendel	German
wendell	German
werner	German
wernher	German
west	German
westerberg	German
wetterman	German
wetzel	German
wexler	German
wieck	German
wiegand	German
wildgrube	German
winter	German
winther	German
wirner	German
wirnhier	German
wirt	German
wirth	German
wolf	German
wolff	German
wolter	German
worner	German
wornhor	German
wruck	German
wyman	German
xylander	German
zellweger	German
zilberschlag	German
zimmerman	German
zimmermann	German
abel	French
abraham	French
adam	French
albert	French
allard	French
archambault	French
armistead	French
arthur	French
augustin	French
babineaux	French
baudin	French
beauchene	French
beaulieu	French
beaumont	French
belanger	French
bellamy	French
bellerose	French
belrose	French
berger	French
beringer	French
bernard	French
bertrand	French
bisset	French
bissette	French
blaise	French
blanc	French
blanchet	French
blanchett	French
bonfils	French
bonheur	French
bonhomme	French
bonnaire	French
bonnay	French
bonner	French
bonnet	French
borde	French
bordelon	French
bouchard	French
boucher	French
brisbois	French
brodeur	French
bureau	French
caron	French
cavey	French
chaput	French
charbonneau	French
charpentier	French
charron	French
chastain	French
chevalier	French
chevrolet	French
cloutier	French
colbert	French
comtois	French
cornett	French
cote	French
coupe	French
courtemanche	French
cousineau	French
couture	French
daniau	French
d'aramitz	French
daviau	French
david	French
deforest	French
degarmo	French
delacroix	French
de la fontaine	French
deniau	French
deniaud	French
deniel	French
denis	French
de sauveterre	French
deschamps	French
descoteaux	French
desjardins	French
desrochers	French
desrosiers	French
dubois	French
duchamps	French
dufort	French
dufour	French
duguay	French
dupond	French
dupont	French
durand	French
durant	French
duval	French
emile	French
eustis	French
fabian	French
fabre	French
fabron	French
faucher	French
faucheux	French
faure	French
favager	French
favre	French
favreau	French
fay	French
felix	French
firmin	French
fontaine	French
forest	French
forestier	French
fortier	French
foss	French
fournier	French
gage	French
gagne	French
gagnier	French
gagnon	French
garcon	French
gardinier	French
germain	French
geroux	French
giles	French
girard	French
giroux	French
glaisyer	French
gosse	French
gosselin	French
granger	French
guerin	French
guillory	French
hardy	French
harman	French
hebert	French
herbert	French
herriot	French
jacques	French
janvier	French
jordan	French
joubert	French
labelle	French
lachance	French
lachapelle	French
lamar	French
lambert	French
lane	French
langlais	French
langlois	French
lapointe	French
larue	French
laurent	French
lavigne	French
lavoie	French
leandres	French
lebeau	French
leblanc	French
leclair	French
leclerc	French
lecuyer	French
lefebvre	French
lefevre	French
lefurgey	French
legrand	French
lemaire	French
lemieux	French
leon	French
leroy	French
lesauvage	French
lestrange	French
leveque	French
levesque	French
linville	French
lyon	French
macon	French
marchand	French
marie	French
marion	French
martel	French
martin	French
masson	French
mathieu	French
mercier	French
merle	French
michaud	French
michel	French
monet	French
monette	French
montagne	French
moreau	French
moulin	French
mullins	French
noel	French
oliver	French
olivier	French
page	French
paget	French
palomer	French
pan	French
pape	French
paquet	French
parent	French
paris	French
parris	French
pascal	French
patenaude	French
paternoster	French
paul	French
pelletier	French
perrault	French
perreault	French
perrot	French
petit	French
pettigrew	French
pierre	French
plamondon	French
plourde	French
poingdestre	French
poirier	French
porcher	French
poulin	French
proulx	French
renaud	French
rey	French
reyer	French
richard	French
richelieu	French
robert	French
roche	French
rome	French
romilly	French
rose	French
rousseau	French
roux	French
roy	French
royer	French
salomon	French
salvage	French
samson	French
samuel	French
sargent	French
sarkozi	French
sarkozy	French
sartre	French
sault	French
sauvage	French
sauvageau	French
sauvageon	French
sauvageot	French
sauveterre	French
savatier	French
segal	French
sergeant	French
severin	French
simon	French
solomon	French
soucy	French
st martin	French
st pierre	French
tailler	French
tasse	French
thayer	French
thibault	French
thomas	French
tobias	French
tolbert	French
traver	French
travere	French
travers	French
traverse	French
travert	French
tremblay	French
tremble	French
victor	French
victors	French
villeneuve	French
vincent	French
vipond	French
voclain	French
yount	French
